-	ãƒ¼
~	ã€œ
.	ã€‚
,	ã€
;/	ãƒ»
;.	â€¦
;,	â€¥
;h	â†
;j	â†“
;k	â†‘
;l	â†’
;-	ã€œ
;[	ã€
;]	ã€
[	ã€Œ
]	ã€
va	ã‚”ã
vi	ã‚”ãƒ
vu	ã‚”
ve	ã‚”ã‡
vo	ã‚”ã‰
v'	ã‚”ãã„
v,	ã‚”ã‰ã†
v.	ã‚”ã‡ã„
v;	ã‚”ãã‚“
vq	ã‚”ã‰ã‚“
vj	ã‚”ã‡ã‚“
vx	ã‚”ãƒã‚“
vya	ã‚”ã‚ƒ
vyi	ã‚”ãƒ
vyu	ã‚”ã‚…
vye	ã‚”ã‡
vyo	ã‚”ã‚‡
vha	ã‚”ã‚ƒ
vhi	ã‚”ãƒ
vhu	ã‚”ã‚…
vhe	ã‚”ã‡
vho	ã‚”ã‚‡
vh'	ã‚”ãã„
vh,	ã‚”ã‚‡ã†
vh.	ã‚”ã‡ã„
vhp	ã‚”ã‚…ã†
vh;	ã‚”ã‚ƒã‚“
vhq	ã‚”ã‚‡ã‚“
vhj	ã‚”ã‡ã‚“
vhk	ã‚”ã‚…ã‚“
vhx	ã‚”ãƒã‚“
qq	ã£	q
vv	ã£	v
ll	ã£	l
xx	ã£	x
kk	ã£	k
cc	ã£	c
gg	ã£	g
ss	ã£	s
zz	ã£	z
jj	ã£	j
tt	ã£	t
dd	ã£	d
hh	ã£	h
ff	ã£	f
bb	ã£	b
pp	ã£	p
mm	ã£	m
yy	ã£	y
rr	ã£	r
ww	ã£	w
www	w	ww
kya	ãã‚ƒ
kyi	ããƒ
kyu	ãã‚…
kye	ãã‡
kyo	ãã‚‡
ky'	ãã‚ƒã„
ky,	ãã‚‡ã†
ky.	ãã‡ã„
kyp	ãã‚…ã†
ky;	ãã‚ƒã‚“
kyq	ãã‚‡ã‚“
kyj	ãã‡ã‚“
kyk	ãã‚…ã‚“
kyx	ããƒã‚“
kha	ãã‚ƒ
khi	ããƒ
khu	ãã‚…
khe	ãã‡
kho	ãã‚‡
kh'	ãã‚ƒã„
kh,	ãã‚‡ã†
kh.	ãã‡ã„
khp	ãã‚…ã†
kh;	ãã‚ƒã‚“
khq	ãã‚‡ã‚“
khj	ãã‡ã‚“
khk	ãã‚…ã‚“
khx	ããƒã‚“
cya	ãã‚ƒ
cyi	ããƒ
cyu	ãã‚…
cye	ãã‡
cyo	ãã‚‡
cy'	ãã‚ƒã„
cy,	ãã‚‡ã†
cy.	ãã‡ã„
cyp	ãã‚…ã†
cy;	ãã‚ƒã‚“
cyq	ãã‚‡ã‚“
cyj	ãã‡ã‚“
cyk	ãã‚…ã‚“
cyx	ããƒã‚“
cna	ãã‚ƒ
cni	ããƒ
cnu	ãã‚…
cne	ãã‡
cno	ãã‚‡
cn'	ãã‚ƒã„
cn,	ãã‚‡ã†
cn.	ãã‡ã„
cnp	ãã‚…ã†
cn;	ãã‚ƒã‚“
cnq	ãã‚‡ã‚“
cnj	ãã‡ã‚“
cnk	ãã‚…ã‚“
cnx	ããƒã‚“
gya	ãã‚ƒ
gyi	ããƒ
gyu	ãã‚…
gye	ãã‡
gyo	ãã‚‡
gy'	ãã‚ƒã„
gy,	ãã‚‡ã†
gy.	ãã‡ã„
gyp	ãã‚…ã†
gy;	ãã‚ƒã‚“
gyq	ãã‚‡ã‚“
gyj	ãã‡ã‚“
gyk	ãã‚…ã‚“
gyx	ããƒã‚“
gna	ãã‚ƒ
gni	ããƒ
gnu	ãã‚…
gne	ãã‡
gno	ãã‚‡
gn'	ãã‚ƒã„
gn,	ãã‚‡ã†
gn.	ãã‡ã„
gnp	ãã‚…ã†
gn;	ãã‚ƒã‚“
gnq	ãã‚‡ã‚“
gnj	ãã‡ã‚“
gnk	ãã‚…ã‚“
gnx	ããƒã‚“
sya	ã—ã‚ƒ
syi	ã—ãƒ
syu	ã—ã‚…
sye	ã—ã‡
syo	ã—ã‚‡
sy'	ã—ã‚ƒã„
sy,	ã—ã‚‡ã†
sy.	ã—ã‡ã„
syp	ã—ã‚…ã†
sy;	ã—ã‚ƒã‚“
syq	ã—ã‚‡ã‚“
syj	ã—ã‡ã‚“
syk	ã—ã‚…ã‚“
syx	ã—ã‚“
sha	ã—ã‚ƒ
shi	ã—
shu	ã—ã‚…
she	ã—ã‡
sho	ã—ã‚‡
sh'	ã—ã‚ƒã„
sh,	ã—ã‚‡ã†
sh.	ã—ã‡ã„
shp	ã—ã‚…ã†
sh;	ã—ã‚ƒã‚“
shq	ã—ã‚‡ã‚“
shj	ã—ã‡ã‚“
shk	ã—ã‚…ã‚“
shx	ã—ã‚“
zya	ã˜ã‚ƒ
zyi	ã˜ãƒ
zyu	ã˜ã‚…
zye	ã˜ã‡
zyo	ã˜ã‚‡
zy'	ã˜ã‚ƒã„
zy,	ã˜ã‚‡ã†
zy.	ã˜ã‡ã„
zyp	ã˜ã‚…ã†
zy;	ã˜ã‚ƒã‚“
zyq	ã˜ã‚‡ã‚“
zyj	ã˜ã‡ã‚“
zyk	ã˜ã‚…ã‚“
zyx	ã˜ãƒã‚“
zha	ã˜ã‚ƒ
zhi	ã˜ãƒ
zhu	ã˜ã‚…
zhe	ã˜ã‡
zho	ã˜ã‚‡
zh'	ã˜ã‚ƒã„
zh,	ã˜ã‚‡ã†
zh.	ã˜ã‡ã„
zhp	ã˜ã‚…ã†
zh;	ã˜ã‚ƒã‚“
zhq	ã˜ã‚‡ã‚“
zhj	ã˜ã‡ã‚“
zhk	ã˜ã‚…ã‚“
zhx	ã˜ãƒã‚“
tya	ã¡ã‚ƒ
tyi	ã¡ãƒ
tyu	ã¡ã‚…
tye	ã¡ã‡
tyo	ã¡ã‚‡
ty'	ã¡ã‚ƒã„
ty,	ã¡ã‚‡ã†
ty.	ã¡ã‡ã„
typ	ã¡ã‚…ã†
ty;	ã¡ã‚ƒã‚“
tyq	ã¡ã‚‡ã‚“
tyj	ã¡ã‡ã‚“
tyk	ã¡ã‚…ã‚“
tyx	ã¡ãƒã‚“
tna	ã¡ã‚ƒ
tni	ã¡ãƒ
tnu	ã¡ã‚…
tne	ã¡ã‡
tno	ã¡ã‚‡
tn'	ã¡ã‚ƒã„
tn,	ã¡ã‚‡ã†
tn.	ã¡ã‡ã„
tnp	ã¡ã‚…ã†
tn;	ã¡ã‚ƒã‚“
tnq	ã¡ã‚‡ã‚“
tnj	ã¡ã‡ã‚“
tnk	ã¡ã‚…ã‚“
tnx	ã¡ãƒã‚“
cha	ã¡ã‚ƒ
chi	ã¡
chu	ã¡ã‚…
che	ã¡ã‡
cho	ã¡ã‚‡
ch'	ã¡ã‚ƒã„
ch,	ã¡ã‚‡ã†
ch.	ã¡ã‡ã„
chp	ã¡ã‚…ã†
ch;	ã¡ã‚ƒã‚“
chq	ã¡ã‚‡ã‚“
chj	ã¡ã‡ã‚“
chk	ã¡ã‚…ã‚“
chx	ã¡ã‚“
cya	ã¡ã‚ƒ
cyi	ã¡ãƒ
cyu	ã¡ã‚…
cye	ã¡ã‡
cyo	ã¡ã‚‡
cy'	ã¡ã‚ƒã„
cy,	ã¡ã‚‡ã†
cy.	ã¡ã‡ã„
cyp	ã¡ã‚…ã†
cy;	ã¡ã‚ƒã‚“
cyq	ã¡ã‚‡ã‚“
cyj	ã¡ã‡ã‚“
cyk	ã¡ã‚…ã†
cyx	ã¡ãƒã‚“
dya	ã¢ã‚ƒ
dyi	ã¢ãƒ
dyu	ã¢ã‚…
dye	ã¢ã‡
dyo	ã¢ã‚‡
dy'	ã¢ã‚ƒã„
dy,	ã¢ã‚‡ã†
dy.	ã¢ã‡ã„
dyp	ã¢ã‚…ã†
dy;	ã¢ã‚ƒã‚“
dyq	ã¢ã‚‡ã‚“
dyj	ã¢ã‡ã‚“
dyk	ã¢ã‚…ã‚“
dyx	ã¢ãƒã‚“
dna	ã¢ã‚ƒ
dni	ã¢ãƒ
dnu	ã¢ã‚…
dne	ã¢ã‡
dno	ã¢ã‚‡
dn'	ã¢ã‚ƒã„
dn,	ã¢ã‚‡ã†
dn.	ã¢ã‡ã„
dnp	ã¢ã‚…ã†
dn;	ã¢ã‚ƒã‚“
dnq	ã¢ã‚‡ã‚“
dnj	ã¢ã‡ã‚“
dnk	ã¢ã‚…ã‚“
dnx	ã¢ãƒã‚“
tsa	ã¤ã
tsi	ã¤ãƒ
tsu	ã¤
tse	ã¤ã‡
tso	ã¤ã‰
ts'	ã¤ãã„
ts,	ã¤ã‰ã†
ts.	ã¤ã‡ã„
tsp	ã¤ã†
ts;	ã¤ãã‚“
tsq	ã¤ã‰ã‚“
tsj	ã¤ã‡ã‚“
tsk	ã¤ã‚“
tsx	ã¤ãƒã‚“
tha	ã¦ã‚ƒ
thi	ã¦ãƒ
thu	ã¦ã‚…
the	ã¦ã‡
tho	ã¦ã‚‡
th'	ã¦ã‚ƒã„
th,	ã¦ã‚‡ã†
th.	ã¦ã‡ã„
thp	ã¦ã‚…ã†
th;	ã¦ã‚ƒã‚“
thq	ã¦ã‚‡ã‚“
thj	ã¦ã‡ã‚“
thk	ã¦ã‚…ã‚“
thx	ã¦ãƒã‚“
dha	ã§ã‚ƒ
dhi	ã§ãƒ
dhu	ã§ã‚…
dhe	ã§ã‡
dho	ã§ã‚‡
dh'	ã§ã‚ƒã„
dh,	ã§ã‚‡ã†
dh.	ã§ã‡ã„
dhp	ã§ã‚…ã†
dh;	ã§ã‚ƒã‚“
dhq	ã§ã‚‡ã‚“
dhj	ã§ã‡ã‚“
dhk	ã§ã‚…ã‚“
dhx	ã§ãƒã‚“
twa	ã¨ã
twi	ã¨ãƒ
twu	ã¨ã…
twe	ã¨ã‡
two	ã¨ã‰
tw'	ã¨ãã„
tw,	ã¨ã‰ã†
tw.	ã¨ã‡ã„
twp	ã¨ã…ã†
tw;	ã¨ãã‚“
twq	ã¨ã‰ã‚“
twj	ã¨ã‡ã‚“
twk	ã¨ã…ã‚“
twx	ã¨ãƒã‚“
dwa	ã©ã
dwi	ã©ãƒ
dwu	ã©ã…
dwe	ã©ã‡
dwo	ã©ã‰
dw'	ã©ãã„
dw,	ã©ã‰ã†
dw.	ã©ã‡ã„
dwp	ã©ã…ã†
dw;	ã©ãã‚“
dwq	ã©ã‰ã‚“
dwj	ã©ã‡ã‚“
dwk	ã©ã…ã‚“
dwx	ã©ãƒã‚“
nya	ã«ã‚ƒ
nyi	ã«ãƒ
nyu	ã«ã‚…
nye	ã«ã‡
nyo	ã«ã‚‡
ny'	ã«ã‚ƒã„
ny,	ã«ã‚‡ã†
ny.	ã«ã‡ã„
nyp	ã«ã‚…ã†
ny;	ã«ã‚ƒã‚“
nyq	ã«ã‚‡ã‚“
nyj	ã«ã‡ã‚“
nyk	ã«ã‚…ã‚“
nyx	ã«ãƒã‚“
nha	ã«ã‚ƒ
nhi	ã«ãƒ
nhu	ã«ã‚…
nhe	ã«ã‡
nho	ã«ã‚‡
nh'	ã«ã‚ƒã„
nh,	ã«ã‚‡ã†
nh.	ã«ã‡ã„
nhp	ã«ã‚…ã†
nh;	ã«ã‚ƒã‚“
nhq	ã«ã‚‡ã‚“
nhj	ã«ã‡ã‚“
nhk	ã«ã‚…ã‚“
nhx	ã«ãƒã‚“
hya	ã²ã‚ƒ
hyi	ã²ãƒ
hyu	ã²ã‚…
hye	ã²ã‡
hyo	ã²ã‚‡
hy'	ã²ã‚ƒã„
hy,	ã²ã‚‡ã†
hy.	ã²ã‡ã„
hyp	ã²ã‚…ã†
hy;	ã²ã‚ƒã‚“
hyq	ã²ã‚‡ã‚“
hyj	ã²ã‡ã‚“
hyk	ã²ã‚…ã‚“
hyx	ã²ãƒã‚“
hna	ã²ã‚ƒ
hni	ã²ãƒ
hnu	ã²ã‚…
hne	ã²ã‡
hno	ã²ã‚‡
hn'	ã²ã‚ƒã„
hn,	ã²ã‚‡ã†
hn.	ã²ã‡ã„
hnp	ã²ã‚…ã†
hn;	ã²ã‚ƒã‚“
hnq	ã²ã‚‡ã‚“
hnj	ã²ã‡ã‚“
hnk	ã²ã‚…ã‚“
hnx	ã²ãƒã‚“
bya	ã³ã‚ƒ
byi	ã³ãƒ
byu	ã³ã‚…
bye	ã³ã‡
byo	ã³ã‚‡
by'	ã³ã‚ƒã„
by,	ã³ã‚‡ã†
by.	ã³ã‡ã„
byp	ã³ã‚…ã†
by;	ã³ã‚ƒã‚“
byq	ã³ã‚‡ã‚“
byj	ã³ã‡ã‚“
byk	ã³ã‚…ã‚“
byx	ã³ãƒã‚“
bna	ã³ã‚ƒ
bni	ã³ãƒ
bnu	ã³ã‚…
bne	ã³ã‡
bno	ã³ã‚‡
bn'	ã³ã‚ƒã„
bn,	ã³ã‚‡ã†
bn.	ã³ã‡ã„
bnp	ã³ã‚…ã†
bn;	ã³ã‚ƒã‚“
bnq	ã³ã‚‡ã‚“
bnj	ã³ã‡ã‚“
bnk	ã³ã‚…ã‚“
bnx	ã³ãƒã‚“
pya	ã´ã‚ƒ
pyi	ã´ãƒ
pyu	ã´ã‚…
pye	ã´ã‡
pyo	ã´ã‚‡
py'	ã´ã‚ƒã„
py,	ã´ã‚‡ã†
py.	ã´ã‡ã„
pyp	ã´ã‚…ã†
py;	ã´ã‚ƒã‚“
pyq	ã´ã‚‡ã‚“
pyj	ã´ã‡ã‚“
pyk	ã´ã‚…ã‚“
pyx	ã´ãƒã‚“
pha	ã´ã‚ƒ
phi	ã´ãƒ
phu	ã´ã‚…
phe	ã´ã‡
pho	ã´ã‚‡
ph'	ã´ã‚ƒã„
ph,	ã´ã‚‡ã†
ph.	ã´ã‡ã„
php	ã´ã‚…ã†
ph;	ã´ã‚ƒã‚“
phq	ã´ã‚‡ã‚“
phj	ã´ã‡ã‚“
phk	ã´ã‚…ã‚“
phx	ã´ãƒã‚“
fa	ãµã
fi	ãµãƒ
fu	ãµ
fe	ãµã‡
fo	ãµã‰
f'	ãµãã„
f,	ãµã‰ã†
f.	ãµã‡ã„
fp	ãµã†
f;	ãµãã‚“
fq	ãµã‰ã‚“
fj	ãµã‡ã‚“
fk	ãµã‚“
fx	ãµãƒã‚“
fya	ãµã‚ƒ
fyu	ãµã‚…
fyo	ãµã‚‡
fy'	ãµã‚ƒã„
fy,	ãµã‚‡ã†
fyp	ãµã‚…ã†
fy;	ãµã‚ƒã‚“
fyq	ãµã‚‡ã‚“
fyk	ãµã‚…ã‚“
fna	ãµã‚ƒ
fnu	ãµã‚…
fno	ãµã‚‡
fn'	ãµã‚ƒã„
fn,	ãµã‚‡ã†
fnp	ãµã‚…ã†
fn;	ãµã‚ƒã‚“
fnq	ãµã‚‡ã‚“
fnk	ãµã‚…ã‚“
hwa	ãµã
hwi	ãµãƒ
hwe	ãµã‡
hwo	ãµã‰
mya	ã¿ã‚ƒ
myi	ã¿ãƒ
myu	ã¿ã‚…
mye	ã¿ã‡
myo	ã¿ã‚‡
my'	ã¿ã‚ƒã„
my,	ã¿ã‚‡ã†
my.	ã¿ã‡ã„
myp	ã¿ã‚…ã†
my;	ã¿ã‚ƒã‚“
myq	ã¿ã‚‡ã‚“
myj	ã¿ã‡ã‚“
myk	ã¿ã‚…ã‚“
myx	ã¿ãƒã‚“
mna	ã¿ã‚ƒ
mni	ã¿ãƒ
mnu	ã¿ã‚…
mne	ã¿ã‡
mno	ã¿ã‚‡
mn'	ã¿ã‚ƒã„
mn,	ã¿ã‚‡ã†
mn.	ã¿ã‡ã„
mnp	ã¿ã‚…ã†
mn;	ã¿ã‚ƒã‚“
mnq	ã¿ã‚‡ã‚“
mnj	ã¿ã‡ã‚“
mnk	ã¿ã‚…ã‚“
mnx	ã¿ãƒã‚“
rya	ã‚Šã‚ƒ
ryi	ã‚Šãƒ
ryu	ã‚Šã‚…
rye	ã‚Šã‡
ryo	ã‚Šã‚‡
ry'	ã‚Šã‚ƒã„
ry,	ã‚Šã‚‡ã†
ry.	ã‚Šã‡ã„
ryp	ã‚Šã‚…ã†
ry;	ã‚Šã‚ƒã‚“
ryq	ã‚Šã‚‡ã‚“
ryj	ã‚Šã‡ã‚“
ryk	ã‚Šã‚…ã‚“
ryx	ã‚Šãƒã‚“
rha	ã‚Šã‚ƒ
rhi	ã‚Šãƒ
rhu	ã‚Šã‚…
rhe	ã‚Šã‡
rho	ã‚Šã‚‡
rh'	ã‚Šã‚ƒã„
rh,	ã‚Šã‚‡ã†
rh.	ã‚Šã‡ã„
rhp	ã‚Šã‚…ã†
rh;	ã‚Šã‚ƒã‚“
rhq	ã‚Šã‚‡ã‚“
rhj	ã‚Šã‡ã‚“
rhk	ã‚Šã‚…ã‚“
rhx	ã‚Šãƒã‚“
n'	ã‚“
nn	ã‚“
n	ã‚“
xn	ã‚“
a	ã‚
i	ã„
u	ã†
e	ãˆ
o	ãŠ
xa	ã
xi	ãƒ
xu	ã…
xe	ã‡
xo	ã‰
x'	ãã„
x,	ã‰ã†
x.	ã‡ã„
xp	ã…ã†
x;	ãã‚“
xq	ã‰ã‚“
xj	ã‡ã‚“
xk	ã…ã‚“
la	ã
li	ãƒ
lu	ã…
le	ã‡
lo	ã‰
l'	ãã„
l,	ã‰ã†
l.	ã‡ã„
lp	ã…ã†
l;	ãã‚“
lq	ã‰ã‚“
lj	ã‡ã‚“
lk	ã…ã‚“
lx	ãƒã‚“
lyi	ãƒ
xyi	ãƒ
xhi	ãƒ
lye	ã‡
xye	ã‡
xhe	ã‡
ka	ã‹
ki	ã
ku	ã
ke	ã‘
ko	ã“
k'	ã‹ã„
k,	ã“ã†
k.	ã‘ã„
kp	ãã†
k;	ã‹ã‚“
kq	ã“ã‚“
kj	ã‘ã‚“
kx	ãã‚“
xka	ãƒµ
xke	ãƒ¶
lka	ãƒµ
lke	ãƒ¶
ca	ã‹
ci	ã
cu	ã
ce	ã‘
co	ã“
c'	ã‹ã„
c,	ã“ã†
c.	ã‘ã„
cp	ãã†
c;	ã‹ã‚“
cq	ã“ã‚“
cj	ã‘ã‚“
ck	ãã‚“
cx	ãã‚“
xca	ãƒµ
xce	ãƒ¶
lca	ãƒµ
lce	ãƒ¶
ga	ãŒ
gi	ã
gu	ã
ge	ã’
go	ã”
g'	ãŒã„
g,	ã”ã†
g.	ã’ã„
gp	ãã†
g;	ãŒã‚“
gq	ã”ã‚“
gj	ã’ã‚“
gk	ãã‚“
gx	ãã‚“
sa	ã•
si	ã—
su	ã™
se	ã›
so	ã
s'	ã•ã„
s,	ãã†
s.	ã›ã„
sp	ã™ã†
s;	ã•ã‚“
sq	ãã‚“
sj	ã›ã‚“
sk	ã™ã‚“
sx	ã—ã‚“
qa	ãã
qi	ããƒ
qu	ã
qe	ãã‡
qo	ãã‰
q'	ããã„
q,	ãã‰ã†
q.	ãã‡ã„
qp	ãã†
q;	ããã‚“
qj	ãã‡ã‚“
qk	ãã‚“
qx	ããƒã‚“
kwa	ãã
kwi	ããƒ
kwu	ãã…
kwe	ãã‡
kwo	ãã‰
kw'	ããã„
kw,	ãã‰ã†
kw.	ãã‡ã„
kwp	ãã…ã†
kw;	ããã‚“
kwq	ãã‰ã‚“
kwj	ãã‡ã‚“
kwk	ãã…ã‚“
kwx	ããƒã‚“
cwa	ãã
cwi	ããƒ
cwu	ãã…
cwe	ãã‡
cwo	ãã‰
cw'	ããã„
cw,	ãã‰ã†
cw.	ãã‡ã„
cwp	ãã…ã†
cw;	ããã‚“
cwq	ãã‰ã‚“
cwj	ãã‡ã‚“
cwk	ãã…ã‚“
cwx	ããƒã‚“
gwa	ãã
gwi	ããƒ
gwu	ãã…
gwe	ãã‡
gwo	ãã‰
gw'	ããã„
gw,	ãã‰ã†
gw.	ãã‡ã„
gwp	ãã…ã†
gw;	ããã‚“
gwq	ãã‰ã‚“
gwj	ãã‡ã‚“
gwk	ãã…ã‚“
gwx	ããƒã‚“
za	ã–
zi	ã˜
zu	ãš
ze	ãœ
zo	ã
z'	ã–ã„
z,	ãã†
z.	ãœã„
zp	ãšã†
z;	ã–ã‚“
zq	ãã‚“
zj	ãœã‚“
zk	ãšã‚“
zx	ã˜ã‚“
ja	ã˜ã‚ƒ
ji	ã˜
ju	ã˜ã‚…
je	ã˜ã‡
jo	ã˜ã‚‡
j'	ã˜ã‚ƒã„
j,	ã˜ã‚‡ã†
j.	ã˜ã‡ã„
jp	ã˜ã‚…ã†
j;	ã˜ã‚ƒã‚“
jq	ã˜ã‚‡ã‚“
jk	ã˜ã‚…ã‚“
jx	ã˜ã‚“
jya	ã˜ã‚ƒ
jyi	ã˜ãƒ
jyu	ã˜ã‚…
jye	ã˜ã‡
jyo	ã˜ã‚‡
jy'	ã˜ã‚ƒã„
jy,	ã˜ã‚‡ã†
jy.	ã˜ã‡ã„
jyp	ã˜ã‚…ã†
jy;	ã˜ã‚ƒã‚“
jyq	ã˜ã‚‡ã‚“
jyj	ã˜ã‡ã‚“
jyk	ã˜ã‚…ã‚“
jyx	ã˜ãƒã‚“
jha	ã˜ã‚ƒ
jhi	ã˜ãƒ
jhu	ã˜ã‚…
jhe	ã˜ã‡
jho	ã˜ã‚‡
jh'	ã˜ã‚ƒã„
jh,	ã˜ã‚‡ã†
jh.	ã˜ã‡ã„
jhp	ã˜ã‚…ã†
jh;	ã˜ã‚ƒã‚“
jhq	ã˜ã‚‡ã‚“
jhj	ã˜ã‡ã‚“
jhk	ã˜ã‚…ã‚“
jhx	ã˜ãƒã‚“
ta	ãŸ
ti	ã¡
tu	ã¤
te	ã¦
to	ã¨
t'	ãŸã„
t,	ã¨ã†
t.	ã¦ã„
tp	ã¤ã†
t;	ãŸã‚“
tq	ã¨ã‚“
tj	ã¦ã‚“
tk	ã¤ã‚“
tx	ã¡ã‚“
da	ã 
di	ã¢
du	ã¥
de	ã§
do	ã©
d'	ã ã„
d,	ã©ã†
d.	ã§ã„
dp	ã¥ã†
d;	ã ã‚“
dq	ã©ã‚“
dj	ã§ã‚“
dk	ã¥ã‚“
dx	ã¢ã‚“
xtu	ã£
xtsu	ã£
ltu	ã£
ltsu	ã£
na	ãª
ni	ã«
nu	ã¬
ne	ã­
no	ã®
n'	ãªã„
n,	ã®ã†
n.	ã­ã„
np	ã¬ã†
n;	ãªã‚“
nq	ã®ã‚“
nj	ã­ã‚“
nk	ã¬ã‚“
nx	ã«ã‚“
ha	ã¯
hi	ã²
hu	ãµ
fu	ãµ
he	ã¸
ho	ã»
h'	ã¯ã„
h,	ã»ã†
h.	ã¸ã„
hp	ãµã†
h;	ã¯ã‚“
hq	ã»ã‚“
hj	ã¸ã‚“
hk	ãµã‚“
hx	ã²ã‚“
ba	ã°
bi	ã³
bu	ã¶
be	ã¹
bo	ã¼
b'	ã°ã„
b,	ã¼ã†
b.	ã¹ã„
bp	ã¶ã†
b;	ã°ã‚“
bq	ã¼ã‚“
bj	ã¹ã‚“
bk	ã¶ã‚“
bx	ã³ã‚“
pa	ã±
pi	ã´
pu	ã·
pe	ãº
po	ã½
p'	ã±ã„
p,	ã½ã†
p.	ãºã„
p;	ã±ã‚“
pq	ã½ã‚“
pj	ãºã‚“
pk	ã·ã‚“
px	ã´ã‚“
ma	ã¾
mi	ã¿
mu	ã‚€
me	ã‚
mo	ã‚‚
m'	ã¾ã„
m,	ã‚‚ã†
m.	ã‚ã„
mp	ã‚€ã†
m;	ã¾ã‚“
mq	ã‚‚ã‚“
mj	ã‚ã‚“
mk	ã‚€ã‚“
mx	ã¿ã‚“
ya	ã‚„
yu	ã‚†
ye	ã„ã‡
yo	ã‚ˆ
y'	ã‚„ã„
y,	ã‚ˆã†
y.	ã„ã‡ã„
yp	ã‚†ã†
y;	ã‚„ã‚“
yq	ã‚ˆã‚“
yj	ã„ã‡ã‚“
yk	ã‚†ã‚“
xya	ã‚ƒ
xyu	ã‚…
xyo	ã‚‡
xy'	ã‚ƒã„
xy,	ã‚‡ã†
xy.	ã‡ã†
xyp	ã‚‡ã†
xy;	ã‚ƒã‚“
xyq	ã‚‡ã‚“
xyj	ã‡ã‚“
xyk	ã‚…ã‚“
xyx	ãƒã‚“
xha	ã‚ƒ
xhu	ã‚…
xho	ã‚‡
xh'	ã‚ƒã„
xh,	ã‚‡ã†
xh.	ã‡ã†
xhp	ã‚‡ã†
xh;	ã‚ƒã‚“
xhq	ã‚‡ã‚“
xhj	ã‡ã‚“
xhk	ã‚…ã‚“
xhx	ãƒã‚“
lya	ã‚ƒ
lyu	ã‚…
lyo	ã‚‡
ly'	ã‚ƒã„
ly,	ã‚‡ã†
ly.	ã‡ã†
lyp	ã‚‡ã†
ly;	ã‚ƒã‚“
lyq	ã‚‡ã‚“
lyj	ã‡ã‚“
lyk	ã‚…ã‚“
lyx	ãƒã‚“
lha	ã‚ƒ
lhu	ã‚…
lho	ã‚‡
lh'	ã‚ƒã„
lh,	ã‚‡ã†
lh.	ã‡ã†
lhp	ã‚‡ã†
lh;	ã‚ƒã‚“
lhq	ã‚‡ã‚“
lhj	ã‡ã‚“
lhk	ã‚…ã‚“
lhx	ãƒã‚“
wyi	ã‚
wye	ã‚‘
ra	ã‚‰
ri	ã‚Š
ru	ã‚‹
re	ã‚Œ
ro	ã‚
r'	ã‚‰ã„
r,	ã‚ã†
r.	ã‚Œã„
rp	ã‚‹ã†
r;	ã‚‰ã‚“
rq	ã‚ã‚“
rj	ã‚Œã‚“
rk	ã‚‹ã‚“
rx	ã‚Šã‚“
xwa	ã‚
lwa	ã‚
wa	ã‚
wi	ã†ãƒ
wu	ã†
we	ã†ã‡
wo	ã‚’
w'	ã‚ã„
w.	ã†ã‡ã„
wp	ã†ã†
w;	ã‚ã‚“
wj	ã†ã‡ã‚“
wk	ã†ã‚“
wx	ã†ãƒã‚“
wha	ã†ã
whi	ã†ãƒ
whu	ã†
whe	ã†ã‡
who	ã†ã‰
wh'	ã†ãã„
wh,	ã†ã‰ã†
wh.	ã†ã‡ã„
whp	ã†ã†
wh;	ã†ãã‚“
whq	ã†ã‰ã‚“
whj	ã†ã‡ã‚“
whk	ã†ã‚“
whx	ã†ãƒã‚“
:+1:	ğŸ‘
:+1_tone1	ğŸ‘ğŸ»
:+1_tone2	ğŸ‘ğŸ¼
:+1_tone3	ğŸ‘ğŸ½
:+1_tone4	ğŸ‘ğŸ¾
:+1_tone5	ğŸ‘ğŸ¿
:-1:	ğŸ‘
:-1_tone1	ğŸ‘ğŸ»
:-1_tone2	ğŸ‘ğŸ¼
:-1_tone3	ğŸ‘ğŸ½
:-1_tone4	ğŸ‘ğŸ¾
:-1_tone5	ğŸ‘ğŸ¿
:100	ğŸ’¯
:1234	ğŸ”¢
:8ball	ğŸ±
:a:	ğŸ…°
:ab:	ğŸ†
:abacus	ğŸ§®
:abc:	ğŸ”¤
:abcd	ğŸ”¡
:ac:	ğŸ‡¦ğŸ‡¨
:accept	ğŸ‰‘
:ad:	ğŸ‡¦ğŸ‡©
:admission_tickets	ğŸŸ
:adult:	ğŸ§‘
:adult_dark_skin_tone	ğŸ§‘ğŸ¿
:adult_light_skin_tone	ğŸ§‘ğŸ»
:adult_medium_dark_skin_tone	ğŸ§‘ğŸ¾
:adult_medium_light_skin_tone	ğŸ§‘ğŸ¼
:adult_medium_skin_tone	ğŸ§‘ğŸ½
:adult_tone1	ğŸ§‘ğŸ»
:adult_tone2	ğŸ§‘ğŸ¼
:adult_tone3	ğŸ§‘ğŸ½
:adult_tone4	ğŸ§‘ğŸ¾
:adult_tone5	ğŸ§‘ğŸ¿
:ae:	ğŸ‡¦ğŸ‡ª
:aerial_tramway	ğŸš¡
:af	ğŸ‡¦ğŸ‡«
:ag	ğŸ‡¦ğŸ‡¬
:ai:	ğŸ‡¦ğŸ‡®
:airplane:	âœˆ
:airplane_arriving	ğŸ›¬
:airplane_departure	ğŸ›«
:airplane_small	ğŸ›©
:al:	ğŸ‡¦ğŸ‡±
:alarm_clock	â°
:alembic	âš—
:alien	ğŸ‘½
:am:	ğŸ‡¦ğŸ‡²
:ambulance	ğŸš‘
:amphora	ğŸº
:anchor	âš“
:angel:	ğŸ‘¼
:angel_tone1	ğŸ‘¼ğŸ»
:angel_tone2	ğŸ‘¼ğŸ¼
:angel_tone3	ğŸ‘¼ğŸ½
:angel_tone4	ğŸ‘¼ğŸ¾
:angel_tone5	ğŸ‘¼ğŸ¿
:anger:	ğŸ’¢
:anger_right	ğŸ—¯
:angry	ğŸ˜ 
:anguished	ğŸ˜§
:ant	ğŸœ
:ao	ğŸ‡¦ğŸ‡´
:apple	ğŸ
:aq:	ğŸ‡¦ğŸ‡¶
:aquarius	â™’
:ar:	ğŸ‡¦ğŸ‡·
:archery	ğŸ¹
:aries	â™ˆ
:arrow_backward	â—€
:arrow_double_down	â¬
:arrow_double_up	â«
:arrow_down:	â¬‡
:arrow_down_small	ğŸ”½
:arrow_forward	â–¶
:arrow_heading_down	â¤µ
:arrow_heading_up	â¤´
:arrow_left	â¬…
:arrow_lower_left	â†™
:arrow_lower_right	â†˜
:arrow_right:	â¡
:arrow_right_hook	â†ª
:arrow_up:	â¬†
:arrow_up_down	â†•
:arrow_up_small	ğŸ”¼
:arrow_upper_left	â†–
:arrow_upper_right	â†—
:arrows_clockwise	ğŸ”ƒ
:arrows_counterclockwise	ğŸ”„
:art:	ğŸ¨
:articulated_lorry	ğŸš›
:as:	ğŸ‡¦ğŸ‡¸
:asterisk:	*ï¸âƒ£
:asterisk_symbol	*
:astonished	ğŸ˜²
:at:	ğŸ‡¦ğŸ‡¹
:athletic_shoe	ğŸ‘Ÿ
:atm	ğŸ§
:atom	âš›
:au	ğŸ‡¦ğŸ‡º
:avocado	ğŸ¥‘
:aw	ğŸ‡¦ğŸ‡¼
:ax	ğŸ‡¦ğŸ‡½
:az	ğŸ‡¦ğŸ‡¿
:b:	ğŸ…±
:ba:	ğŸ‡§ğŸ‡¦
:baby:	ğŸ‘¶
:baby_bottle	ğŸ¼
:baby_chick	ğŸ¤
:baby_symbol	ğŸš¼
:baby_tone1	ğŸ‘¶ğŸ»
:baby_tone2	ğŸ‘¶ğŸ¼
:baby_tone3	ğŸ‘¶ğŸ½
:baby_tone4	ğŸ‘¶ğŸ¾
:baby_tone5	ğŸ‘¶ğŸ¿
:back:	ğŸ”™
:back_of_hand:	ğŸ¤š
:back_of_hand_tone1	ğŸ¤šğŸ»
:back_of_hand_tone2	ğŸ¤šğŸ¼
:back_of_hand_tone3	ğŸ¤šğŸ½
:back_of_hand_tone4	ğŸ¤šğŸ¾
:back_of_hand_tone5	ğŸ¤šğŸ¿
:bacon	ğŸ¥“
:badger	ğŸ¦¡
:badminton	ğŸ¸
:bagel	ğŸ¥¯
:baggage_claim	ğŸ›„
:baguette_bread	ğŸ¥–
:bald	ğŸ¦²
:balloon	ğŸˆ
:ballot_box:	ğŸ—³
:ballot_box_with_check	â˜‘
:bamboo	ğŸ
:banana	ğŸŒ
:bangbang	â€¼
:bank	ğŸ¦
:bar_chart	ğŸ“Š
:barber	ğŸ’ˆ
:baseball	âš¾
:basket:	ğŸ§º
:basketball:	ğŸ€
:basketball_player:	â›¹
:basketball_player_tone1	â›¹ğŸ»
:basketball_player_tone2	â›¹ğŸ¼
:basketball_player_tone3	â›¹ğŸ½
:basketball_player_tone4	â›¹ğŸ¾
:basketball_player_tone5	â›¹ğŸ¿
:bat:	ğŸ¦‡
:bath:	ğŸ›€
:bath_tone1	ğŸ›€ğŸ»
:bath_tone2	ğŸ›€ğŸ¼
:bath_tone3	ğŸ›€ğŸ½
:bath_tone4	ğŸ›€ğŸ¾
:bath_tone5	ğŸ›€ğŸ¿
:bathtub	ğŸ›
:battery	ğŸ”‹
:bb	ğŸ‡§ğŸ‡§
:bd	ğŸ‡§ğŸ‡©
:be:	ğŸ‡§ğŸ‡ª
:beach:	ğŸ–
:beach_umbrella	â›±
:bear:	ğŸ»
:bearded_person:	ğŸ§”
:bearded_person_dark_skin_tone	ğŸ§”ğŸ¿
:bearded_person_light_skin_tone	ğŸ§”ğŸ»
:bearded_person_medium_dark_skin_tone	ğŸ§”ğŸ¾
:bearded_person_medium_light_skin_tone	ğŸ§”ğŸ¼
:bearded_person_medium_skin_tone	ğŸ§”ğŸ½
:bearded_person_tone1	ğŸ§”ğŸ»
:bearded_person_tone2	ğŸ§”ğŸ¼
:bearded_person_tone3	ğŸ§”ğŸ½
:bearded_person_tone4	ğŸ§”ğŸ¾
:bearded_person_tone5	ğŸ§”ğŸ¿
:bed	ğŸ›
:bee:	ğŸ
:beer:	ğŸº
:beers	ğŸ»
:beetle	ğŸ
:beginner	ğŸ”°
:bell:	ğŸ””
:bellhop	ğŸ›
:bento	ğŸ±
:bf	ğŸ‡§ğŸ‡«
:bg	ğŸ‡§ğŸ‡¬
:bh	ğŸ‡§ğŸ‡­
:bi:	ğŸ‡§ğŸ‡®
:bicyclist:	ğŸš´
:bicyclist_tone1	ğŸš´ğŸ»
:bicyclist_tone2	ğŸš´ğŸ¼
:bicyclist_tone3	ğŸš´ğŸ½
:bicyclist_tone4	ğŸš´ğŸ¾
:bicyclist_tone5	ğŸš´ğŸ¿
:bike	ğŸš²
:bikini	ğŸ‘™
:billed_cap	ğŸ§¢
:biohazard	â˜£
:bird	ğŸ¦
:birthday	ğŸ‚
:bj	ğŸ‡§ğŸ‡¯
:bl:	ğŸ‡§ğŸ‡±
:black_circle	âš«
:black_heart	ğŸ–¤
:black_joker	ğŸƒ
:black_large_square	â¬›
:black_medium_small_square	â—¾
:black_medium_square	â—¼
:black_nib	âœ’
:black_small_square	â–ª
:black_square_button	ğŸ”²
:blond-haired_man	ğŸ‘±â€â™‚ï¸
:blond-haired_woman	ğŸ‘±â€â™€ï¸
:blond_haired_person:	ğŸ‘±
:blond_haired_person_tone1	ğŸ‘±ğŸ»
:blond_haired_person_tone2	ğŸ‘±ğŸ¼
:blond_haired_person_tone3	ğŸ‘±ğŸ½
:blond_haired_person_tone4	ğŸ‘±ğŸ¾
:blond_haired_person_tone5	ğŸ‘±ğŸ¿
:blossom	ğŸŒ¼
:blowfish	ğŸ¡
:blue_book	ğŸ“˜
:blue_car	ğŸš™
:blue_circle	ğŸ”µ
:blue_heart	ğŸ’™
:blush	ğŸ˜Š
:bm	ğŸ‡§ğŸ‡²
:bn	ğŸ‡§ğŸ‡³
:bo:	ğŸ‡§ğŸ‡´
:boar	ğŸ—
:bomb	ğŸ’£
:bone	ğŸ¦´
:book:	ğŸ“–
:bookmark:	ğŸ”–
:bookmark_tabs	ğŸ“‘
:books	ğŸ“š
:boom	ğŸ’¥
:boot	ğŸ‘¢
:bottle_with_popping_cork	ğŸ¾
:bouquet	ğŸ’
:bow:	ğŸ™‡
:bow_and_arrow	ğŸ¹
:bow_tone1	ğŸ™‡ğŸ»
:bow_tone2	ğŸ™‡ğŸ¼
:bow_tone3	ğŸ™‡ğŸ½
:bow_tone4	ğŸ™‡ğŸ¾
:bow_tone5	ğŸ™‡ğŸ¿
:bowl_with_spoon	ğŸ¥£
:bowling	ğŸ³
:boxing_glove	ğŸ¥Š
:boy:	ğŸ‘¦
:boy_tone1	ğŸ‘¦ğŸ»
:boy_tone2	ğŸ‘¦ğŸ¼
:boy_tone3	ğŸ‘¦ğŸ½
:boy_tone4	ğŸ‘¦ğŸ¾
:boy_tone5	ğŸ‘¦ğŸ¿
:bq	ğŸ‡§ğŸ‡¶
:br:	ğŸ‡§ğŸ‡·
:brain	ğŸ§ 
:bread	ğŸ
:breast_feeding:	ğŸ¤±
:breast_feeding_dark_skin_tone	ğŸ¤±ğŸ¿
:breast_feeding_light_skin_tone	ğŸ¤±ğŸ»
:breast_feeding_medium_dark_skin_tone	ğŸ¤±ğŸ¾
:breast_feeding_medium_light_skin_tone	ğŸ¤±ğŸ¼
:breast_feeding_medium_skin_tone	ğŸ¤±ğŸ½
:breast_feeding_tone1	ğŸ¤±ğŸ»
:breast_feeding_tone2	ğŸ¤±ğŸ¼
:breast_feeding_tone3	ğŸ¤±ğŸ½
:breast_feeding_tone4	ğŸ¤±ğŸ¾
:breast_feeding_tone5	ğŸ¤±ğŸ¿
:bricks	ğŸ§±
:bride_with_veil:	ğŸ‘°
:bride_with_veil_tone1	ğŸ‘°ğŸ»
:bride_with_veil_tone2	ğŸ‘°ğŸ¼
:bride_with_veil_tone3	ğŸ‘°ğŸ½
:bride_with_veil_tone4	ğŸ‘°ğŸ¾
:bride_with_veil_tone5	ğŸ‘°ğŸ¿
:bridge_at_night	ğŸŒ‰
:briefcase	ğŸ’¼
:broccoli	ğŸ¥¦
:broken_heart	ğŸ’”
:broom	ğŸ§¹
:bs	ğŸ‡§ğŸ‡¸
:bt	ğŸ‡§ğŸ‡¹
:bug	ğŸ›
:building_construction	ğŸ—
:bulb	ğŸ’¡
:bullettrain_front	ğŸš…
:bullettrain_side	ğŸš„
:burrito	ğŸŒ¯
:bus:	ğŸšŒ
:busstop	ğŸš
:bust_in_silhouette	ğŸ‘¤
:busts_in_silhouette	ğŸ‘¥
:butterfly	ğŸ¦‹
:bv	ğŸ‡§ğŸ‡»
:bw	ğŸ‡§ğŸ‡¼
:by	ğŸ‡§ğŸ‡¾
:bz	ğŸ‡§ğŸ‡¿
:ca:	ğŸ‡¨ğŸ‡¦
:cactus	ğŸŒµ
:cake	ğŸ°
:calendar:	ğŸ“†
:calendar_spiral	ğŸ—“
:call_me:	ğŸ¤™
:call_me_hand_tone1	ğŸ¤™ğŸ»
:call_me_hand_tone2	ğŸ¤™ğŸ¼
:call_me_hand_tone3	ğŸ¤™ğŸ½
:call_me_hand_tone4	ğŸ¤™ğŸ¾
:call_me_hand_tone5	ğŸ¤™ğŸ¿
:call_me_tone1	ğŸ¤™ğŸ»
:call_me_tone2	ğŸ¤™ğŸ¼
:call_me_tone3	ğŸ¤™ğŸ½
:call_me_tone4	ğŸ¤™ğŸ¾
:call_me_tone5	ğŸ¤™ğŸ¿
:calling	ğŸ“²
:camel	ğŸ«
:camera:	ğŸ“·
:camera_with_flash	ğŸ“¸
:camping	ğŸ•
:cancer	â™‹
:candle	ğŸ•¯
:candy	ğŸ¬
:canned_food	ğŸ¥«
:canoe	ğŸ›¶
:capital_abcd	ğŸ” 
:capricorn	â™‘
:card_box	ğŸ—ƒ
:card_file_box	ğŸ—ƒ
:card_index:	ğŸ“‡
:card_index_dividers	ğŸ—‚
:carousel_horse	ğŸ 
:carrot	ğŸ¥•
:cartwheel:	ğŸ¤¸
:cartwheel_tone1	ğŸ¤¸ğŸ»
:cartwheel_tone2	ğŸ¤¸ğŸ¼
:cartwheel_tone3	ğŸ¤¸ğŸ½
:cartwheel_tone4	ğŸ¤¸ğŸ¾
:cartwheel_tone5	ğŸ¤¸ğŸ¿
:cat2	ğŸˆ
:cat:	ğŸ±
:cc	ğŸ‡¨ğŸ‡¨
:cd	ğŸ’¿
:cf	ğŸ‡¨ğŸ‡«
:cg	ğŸ‡¨ğŸ‡¬
:ch:	ğŸ‡¨ğŸ‡­
:chains	â›“
:champagne:	ğŸ¾
:champagne_glass	ğŸ¥‚
:chart:	ğŸ’¹
:chart_with_downwards_trend	ğŸ“‰
:chart_with_upwards_trend	ğŸ“ˆ
:checkered_flag	ğŸ
:cheese	ğŸ§€
:cherries	ğŸ’
:cherry_blossom	ğŸŒ¸
:chess_pawn	â™Ÿï¸
:chestnut	ğŸŒ°
:chicken	ğŸ”
:child:	ğŸ§’
:child_dark_skin_tone	ğŸ§’ğŸ¿
:child_light_skin_tone	ğŸ§’ğŸ»
:child_medium_dark_skin_tone	ğŸ§’ğŸ¾
:child_medium_light_skin_tone	ğŸ§’ğŸ¼
:child_medium_skin_tone	ğŸ§’ğŸ½
:child_tone1	ğŸ§’ğŸ»
:child_tone2	ğŸ§’ğŸ¼
:child_tone3	ğŸ§’ğŸ½
:child_tone4	ğŸ§’ğŸ¾
:child_tone5	ğŸ§’ğŸ¿
:children_crossing	ğŸš¸
:chile	ğŸ‡¨ğŸ‡±
:chipmunk	ğŸ¿
:chocolate_bar	ğŸ«
:chopsticks	ğŸ¥¢
:christmas_tree	ğŸ„
:church	â›ª
:ci:	ğŸ‡¨ğŸ‡®
:cinema	ğŸ¦
:circus_tent	ğŸª
:city_dusk	ğŸŒ†
:city_sunrise	ğŸŒ‡
:city_sunset	ğŸŒ‡
:cityscape	ğŸ™
:ck	ğŸ‡¨ğŸ‡°
:cl:	ğŸ†‘
:clap:	ğŸ‘
:clap_tone1	ğŸ‘ğŸ»
:clap_tone2	ğŸ‘ğŸ¼
:clap_tone3	ğŸ‘ğŸ½
:clap_tone4	ğŸ‘ğŸ¾
:clap_tone5	ğŸ‘ğŸ¿
:clapper	ğŸ¬
:classical_building	ğŸ›
:clinking_glass	ğŸ¥‚
:clipboard	ğŸ“‹
:clock1030	ğŸ•¥
:clock10:	ğŸ•™
:clock1130	ğŸ•¦
:clock11:	ğŸ•š
:clock1230	ğŸ•§
:clock12:	ğŸ•›
:clock130	ğŸ•œ
:clock1:	ğŸ•
:clock230	ğŸ•
:clock2:	ğŸ•‘
:clock330	ğŸ•
:clock3:	ğŸ•’
:clock430	ğŸ•Ÿ
:clock4:	ğŸ•“
:clock530	ğŸ• 
:clock5:	ğŸ•”
:clock630	ğŸ•¡
:clock6:	ğŸ••
:clock730	ğŸ•¢
:clock7:	ğŸ•–
:clock830	ğŸ•£
:clock8:	ğŸ•—
:clock930	ğŸ•¤
:clock9:	ğŸ•˜
:clock:	ğŸ•°
:closed_book	ğŸ“•
:closed_lock_with_key	ğŸ”
:closed_umbrella	ğŸŒ‚
:cloud:	â˜
:cloud_lightning	ğŸŒ©
:cloud_rain	ğŸŒ§
:cloud_snow	ğŸŒ¨
:cloud_tornado	ğŸŒª
:cloud_with_lightning	ğŸŒ©
:cloud_with_rain	ğŸŒ§
:cloud_with_snow	ğŸŒ¨
:cloud_with_tornado	ğŸŒª
:clown	ğŸ¤¡
:clubs	â™£
:cm	ğŸ‡¨ğŸ‡²
:cn	ğŸ‡¨ğŸ‡³
:co:	ğŸ‡¨ğŸ‡´
:coat	ğŸ§¥
:cocktail	ğŸ¸
:coconut	ğŸ¥¥
:coffee	â˜•
:coffin	âš°
:cold_face	ğŸ¥¶
:cold_sweat	ğŸ˜°
:comet	â˜„
:compass	ğŸ§­
:compression	ğŸ—œ
:computer	ğŸ’»
:confetti_ball	ğŸŠ
:confounded	ğŸ˜–
:confused	ğŸ˜•
:congo	ğŸ‡¨ğŸ‡©
:congratulations	ãŠ—
:construction:	ğŸš§
:construction_site	ğŸ—
:construction_worker:	ğŸ‘·
:construction_worker_tone1	ğŸ‘·ğŸ»
:construction_worker_tone2	ğŸ‘·ğŸ¼
:construction_worker_tone3	ğŸ‘·ğŸ½
:construction_worker_tone4	ğŸ‘·ğŸ¾
:construction_worker_tone5	ğŸ‘·ğŸ¿
:control_knobs	ğŸ›
:convenience_store	ğŸª
:cookie	ğŸª
:cooking	ğŸ³
:cool	ğŸ†’
:cop:	ğŸ‘®
:cop_tone1	ğŸ‘®ğŸ»
:cop_tone2	ğŸ‘®ğŸ¼
:cop_tone3	ğŸ‘®ğŸ½
:cop_tone4	ğŸ‘®ğŸ¾
:cop_tone5	ğŸ‘®ğŸ¿
:copyright	Â©
:corn	ğŸŒ½
:couch	ğŸ›‹
:couple:	ğŸ‘«
:couple_with_heart	ğŸ’‘
:couplekiss	ğŸ’
:cow2	ğŸ„
:cow:	ğŸ®
:cowboy	ğŸ¤ 
:cp	ğŸ‡¨ğŸ‡µ
:cr:	ğŸ‡¨ğŸ‡·
:crab	ğŸ¦€
:crayon	ğŸ–
:credit_card	ğŸ’³
:crescent_moon	ğŸŒ™
:cricket:	ğŸ¦—
:cricket_bat_ball	ğŸ
:cricket_game	ğŸ
:crocodile	ğŸŠ
:croissant	ğŸ¥
:cross:	âœ
:crossed_flags	ğŸŒ
:crossed_swords	âš”
:crown	ğŸ‘‘
:cruise_ship	ğŸ›³
:cry:	ğŸ˜¢
:crying_cat_face	ğŸ˜¿
:crystal_ball	ğŸ”®
:cu:	ğŸ‡¨ğŸ‡º
:cucumber	ğŸ¥’
:cup_with_straw	ğŸ¥¤
:cupcake	ğŸ§
:cupid	ğŸ’˜
:curling_stone	ğŸ¥Œ
:curly_haired	ğŸ¦±
:curly_loop	â°
:currency_exchange	ğŸ’±
:curry	ğŸ›
:custard	ğŸ®
:customs	ğŸ›ƒ
:cut_of_meat	ğŸ¥©
:cv	ğŸ‡¨ğŸ‡»
:cw	ğŸ‡¨ğŸ‡¼
:cx	ğŸ‡¨ğŸ‡½
:cy:	ğŸ‡¨ğŸ‡¾
:cyclone	ğŸŒ€
:cz	ğŸ‡¨ğŸ‡¿
:dagger	ğŸ—¡
:dancer:	ğŸ’ƒ
:dancer_tone1	ğŸ’ƒğŸ»
:dancer_tone2	ğŸ’ƒğŸ¼
:dancer_tone3	ğŸ’ƒğŸ½
:dancer_tone4	ğŸ’ƒğŸ¾
:dancer_tone5	ğŸ’ƒğŸ¿
:dancers	ğŸ‘¯
:dango	ğŸ¡
:dark_sunglasses	ğŸ•¶
:dart	ğŸ¯
:dash	ğŸ’¨
:date	ğŸ“…
:de:	ğŸ‡©ğŸ‡ª
:deciduous_tree	ğŸŒ³
:deer	ğŸ¦Œ
:department_store	ğŸ¬
:derelict_house_building	ğŸš
:desert:	ğŸœ
:desert_island	ğŸ
:desktop	ğŸ–¥
:detective:	ğŸ•µ
:detective_tone1	ğŸ•µğŸ»
:detective_tone2	ğŸ•µğŸ¼
:detective_tone3	ğŸ•µğŸ½
:detective_tone4	ğŸ•µğŸ¾
:detective_tone5	ğŸ•µğŸ¿
:dg	ğŸ‡©ğŸ‡¬
:diamond_shape_with_a_dot_inside	ğŸ’ 
:diamonds	â™¦
:digit_eight	8
:digit_five	5
:digit_four	4
:digit_nine	9
:digit_one	1
:digit_seven	7
:digit_six	6
:digit_three	3
:digit_two	2
:digit_zero	0
:disappointed:	ğŸ˜
:disappointed_relieved	ğŸ˜¥
:dividers	ğŸ—‚
:dizzy:	ğŸ’«
:dizzy_face	ğŸ˜µ
:dj	ğŸ‡©ğŸ‡¯
:dk	ğŸ‡©ğŸ‡°
:dm	ğŸ‡©ğŸ‡²
:dna	ğŸ§¬
:do:	ğŸ‡©ğŸ‡´
:do_not_litter	ğŸš¯
:dog2	ğŸ•
:dog:	ğŸ¶
:dollar	ğŸ’µ
:dolls	ğŸ
:dolphin	ğŸ¬
:door	ğŸšª
:double_vertical_bar	â¸
:doughnut	ğŸ©
:dove	ğŸ•Š
:dragon:	ğŸ‰
:dragon_face	ğŸ²
:dress	ğŸ‘—
:dromedary_camel	ğŸª
:drool:	ğŸ¤¤
:drooling_face	ğŸ¤¤
:droplet	ğŸ’§
:drum	ğŸ¥
:duck	ğŸ¦†
:dumpling	ğŸ¥Ÿ
:dvd	ğŸ“€
:dz	ğŸ‡©ğŸ‡¿
:e-mail	ğŸ“§
:ea:	ğŸ‡ªğŸ‡¦
:eagle	ğŸ¦…
:ear:	ğŸ‘‚
:ear_of_rice	ğŸŒ¾
:ear_tone1	ğŸ‘‚ğŸ»
:ear_tone2	ğŸ‘‚ğŸ¼
:ear_tone3	ğŸ‘‚ğŸ½
:ear_tone4	ğŸ‘‚ğŸ¾
:ear_tone5	ğŸ‘‚ğŸ¿
:earth_africa	ğŸŒ
:earth_americas	ğŸŒ
:earth_asia	ğŸŒ
:ec	ğŸ‡ªğŸ‡¨
:ee	ğŸ‡ªğŸ‡ª
:eg:	ğŸ‡ªğŸ‡¬
:egg:	ğŸ¥š
:eggplant	ğŸ†
:eh	ğŸ‡ªğŸ‡­
:eight:	8ï¸âƒ£
:eight_pointed_black_star	âœ´
:eight_spoked_asterisk	âœ³
:eject	â
:electric_plug	ğŸ”Œ
:elephant	ğŸ˜
:elf:	ğŸ§
:elf_dark_skin_tone	ğŸ§ğŸ¿
:elf_light_skin_tone	ğŸ§ğŸ»
:elf_medium_dark_skin_tone	ğŸ§ğŸ¾
:elf_medium_light_skin_tone	ğŸ§ğŸ¼
:elf_medium_skin_tone	ğŸ§ğŸ½
:elf_tone1	ğŸ§ğŸ»
:elf_tone2	ğŸ§ğŸ¼
:elf_tone3	ğŸ§ğŸ½
:elf_tone4	ğŸ§ğŸ¾
:elf_tone5	ğŸ§ğŸ¿
:email	ğŸ“§
:end	ğŸ”š
:envelope:	âœ‰
:envelope_with_arrow	ğŸ“©
:er	ğŸ‡ªğŸ‡·
:es	ğŸ‡ªğŸ‡¸
:et	ğŸ‡ªğŸ‡¹
:eu:	ğŸ‡ªğŸ‡º
:euro:	ğŸ’¶
:european_castle	ğŸ°
:european_post_office	ğŸ¤
:evergreen_tree	ğŸŒ²
:exclamation	â—
:expecting_woman:	ğŸ¤°
:expecting_woman_tone1	ğŸ¤°ğŸ»
:expecting_woman_tone2	ğŸ¤°ğŸ¼
:expecting_woman_tone3	ğŸ¤°ğŸ½
:expecting_woman_tone4	ğŸ¤°ğŸ¾
:expecting_woman_tone5	ğŸ¤°ğŸ¿
:exploding_head	ğŸ¤¯
:expressionless	ğŸ˜‘
:eye:	ğŸ‘
:eyeglasses	ğŸ‘“
:eyes	ğŸ‘€
:face_palm:	ğŸ¤¦
:face_palm_tone1	ğŸ¤¦ğŸ»
:face_palm_tone2	ğŸ¤¦ğŸ¼
:face_palm_tone3	ğŸ¤¦ğŸ½
:face_palm_tone4	ğŸ¤¦ğŸ¾
:face_palm_tone5	ğŸ¤¦ğŸ¿
:face_vomiting	ğŸ¤®
:face_with_cowboy_hat	ğŸ¤ 
:face_with_hand_over_mouth	ğŸ¤­
:face_with_head_bandage	ğŸ¤•
:face_with_monocle	ğŸ§
:face_with_raised_eyebrow	ğŸ¤¨
:face_with_rolling_eyes	ğŸ™„
:face_with_symbols_over_mouth	ğŸ¤¬
:face_with_thermometer	ğŸ¤’
:facepalm:	ğŸ¤¦
:facepalm_tone1	ğŸ¤¦ğŸ»
:facepalm_tone2	ğŸ¤¦ğŸ¼
:facepalm_tone3	ğŸ¤¦ğŸ½
:facepalm_tone4	ğŸ¤¦ğŸ¾
:facepalm_tone5	ğŸ¤¦ğŸ¿
:factory	ğŸ­
:fairy:	ğŸ§š
:fairy_dark_skin_tone	ğŸ§šğŸ¿
:fairy_light_skin_tone	ğŸ§šğŸ»
:fairy_medium_dark_skin_tone	ğŸ§šğŸ¾
:fairy_medium_light_skin_tone	ğŸ§šğŸ¼
:fairy_medium_skin_tone	ğŸ§šğŸ½
:fairy_tone1	ğŸ§šğŸ»
:fairy_tone2	ğŸ§šğŸ¼
:fairy_tone3	ğŸ§šğŸ½
:fairy_tone4	ğŸ§šğŸ¾
:fairy_tone5	ğŸ§šğŸ¿
:fallen_leaf	ğŸ‚
:family:	ğŸ‘ª
:family_man_boy	ğŸ‘¨â€ğŸ‘¦
:family_man_girl	ğŸ‘¨â€ğŸ‘§
:family_woman_boy	ğŸ‘©â€ğŸ‘¦
:family_woman_girl	ğŸ‘©â€ğŸ‘§
:fast_forward	â©
:fax	ğŸ“ 
:fearful	ğŸ˜¨
:feet	ğŸ¾
:female_sign	â™€
:fencer	ğŸ¤º
:fencing	ğŸ¤º
:ferris_wheel	ğŸ¡
:ferry	â›´
:fi:	ğŸ‡«ğŸ‡®
:field_hockey	ğŸ‘
:file_cabinet	ğŸ—„
:file_folder	ğŸ“
:film_frames	ğŸ
:film_projector	ğŸ“½
:fingers_crossed:	ğŸ¤
:fingers_crossed_tone1	ğŸ¤ğŸ»
:fingers_crossed_tone2	ğŸ¤ğŸ¼
:fingers_crossed_tone3	ğŸ¤ğŸ½
:fingers_crossed_tone4	ğŸ¤ğŸ¾
:fingers_crossed_tone5	ğŸ¤ğŸ¿
:fire:	ğŸ”¥
:fire_engine	ğŸš’
:fire_extinguisher	ğŸ§¯
:firecracker	ğŸ§¨
:fireworks	ğŸ†
:first_place	ğŸ¥‡
:first_quarter_moon:	ğŸŒ“
:first_quarter_moon_with_face	ğŸŒ›
:fish:	ğŸŸ
:fish_cake	ğŸ¥
:fishing_pole_and_fish	ğŸ£
:fist:	âœŠ
:fist_tone1	âœŠğŸ»
:fist_tone2	âœŠğŸ¼
:fist_tone3	âœŠğŸ½
:fist_tone4	âœŠğŸ¾
:fist_tone5	âœŠğŸ¿
:five	5ï¸âƒ£
:fj	ğŸ‡«ğŸ‡¯
:fk	ğŸ‡«ğŸ‡°
:flag_ac	ğŸ‡¦ğŸ‡¨
:flag_ad	ğŸ‡¦ğŸ‡©
:flag_ae	ğŸ‡¦ğŸ‡ª
:flag_af	ğŸ‡¦ğŸ‡«
:flag_ag	ğŸ‡¦ğŸ‡¬
:flag_ai	ğŸ‡¦ğŸ‡®
:flag_al	ğŸ‡¦ğŸ‡±
:flag_am	ğŸ‡¦ğŸ‡²
:flag_ao	ğŸ‡¦ğŸ‡´
:flag_aq	ğŸ‡¦ğŸ‡¶
:flag_ar	ğŸ‡¦ğŸ‡·
:flag_as	ğŸ‡¦ğŸ‡¸
:flag_at	ğŸ‡¦ğŸ‡¹
:flag_au	ğŸ‡¦ğŸ‡º
:flag_aw	ğŸ‡¦ğŸ‡¼
:flag_ax	ğŸ‡¦ğŸ‡½
:flag_az	ğŸ‡¦ğŸ‡¿
:flag_ba	ğŸ‡§ğŸ‡¦
:flag_bb	ğŸ‡§ğŸ‡§
:flag_bd	ğŸ‡§ğŸ‡©
:flag_be	ğŸ‡§ğŸ‡ª
:flag_bf	ğŸ‡§ğŸ‡«
:flag_bg	ğŸ‡§ğŸ‡¬
:flag_bh	ğŸ‡§ğŸ‡­
:flag_bi	ğŸ‡§ğŸ‡®
:flag_bj	ğŸ‡§ğŸ‡¯
:flag_bl:	ğŸ‡§ğŸ‡±
:flag_black	ğŸ´
:flag_bm	ğŸ‡§ğŸ‡²
:flag_bn	ğŸ‡§ğŸ‡³
:flag_bo	ğŸ‡§ğŸ‡´
:flag_bq	ğŸ‡§ğŸ‡¶
:flag_br	ğŸ‡§ğŸ‡·
:flag_bs	ğŸ‡§ğŸ‡¸
:flag_bt	ğŸ‡§ğŸ‡¹
:flag_bv	ğŸ‡§ğŸ‡»
:flag_bw	ğŸ‡§ğŸ‡¼
:flag_by	ğŸ‡§ğŸ‡¾
:flag_bz	ğŸ‡§ğŸ‡¿
:flag_ca	ğŸ‡¨ğŸ‡¦
:flag_cc	ğŸ‡¨ğŸ‡¨
:flag_cd	ğŸ‡¨ğŸ‡©
:flag_cf	ğŸ‡¨ğŸ‡«
:flag_cg	ğŸ‡¨ğŸ‡¬
:flag_ch	ğŸ‡¨ğŸ‡­
:flag_ci	ğŸ‡¨ğŸ‡®
:flag_ck	ğŸ‡¨ğŸ‡°
:flag_cl	ğŸ‡¨ğŸ‡±
:flag_cm	ğŸ‡¨ğŸ‡²
:flag_cn	ğŸ‡¨ğŸ‡³
:flag_co	ğŸ‡¨ğŸ‡´
:flag_cp	ğŸ‡¨ğŸ‡µ
:flag_cr	ğŸ‡¨ğŸ‡·
:flag_cu	ğŸ‡¨ğŸ‡º
:flag_cv	ğŸ‡¨ğŸ‡»
:flag_cw	ğŸ‡¨ğŸ‡¼
:flag_cx	ğŸ‡¨ğŸ‡½
:flag_cy	ğŸ‡¨ğŸ‡¾
:flag_cz	ğŸ‡¨ğŸ‡¿
:flag_de	ğŸ‡©ğŸ‡ª
:flag_dg	ğŸ‡©ğŸ‡¬
:flag_dj	ğŸ‡©ğŸ‡¯
:flag_dk	ğŸ‡©ğŸ‡°
:flag_dm	ğŸ‡©ğŸ‡²
:flag_do	ğŸ‡©ğŸ‡´
:flag_dz	ğŸ‡©ğŸ‡¿
:flag_ea	ğŸ‡ªğŸ‡¦
:flag_ec	ğŸ‡ªğŸ‡¨
:flag_ee	ğŸ‡ªğŸ‡ª
:flag_eg	ğŸ‡ªğŸ‡¬
:flag_eh	ğŸ‡ªğŸ‡­
:flag_er	ğŸ‡ªğŸ‡·
:flag_es	ğŸ‡ªğŸ‡¸
:flag_et	ğŸ‡ªğŸ‡¹
:flag_eu	ğŸ‡ªğŸ‡º
:flag_fi	ğŸ‡«ğŸ‡®
:flag_fj	ğŸ‡«ğŸ‡¯
:flag_fk	ğŸ‡«ğŸ‡°
:flag_fm	ğŸ‡«ğŸ‡²
:flag_fo	ğŸ‡«ğŸ‡´
:flag_fr	ğŸ‡«ğŸ‡·
:flag_ga	ğŸ‡¬ğŸ‡¦
:flag_gb	ğŸ‡¬ğŸ‡§
:flag_gd	ğŸ‡¬ğŸ‡©
:flag_ge	ğŸ‡¬ğŸ‡ª
:flag_gf	ğŸ‡¬ğŸ‡«
:flag_gg	ğŸ‡¬ğŸ‡¬
:flag_gh	ğŸ‡¬ğŸ‡­
:flag_gi	ğŸ‡¬ğŸ‡®
:flag_gl	ğŸ‡¬ğŸ‡±
:flag_gm	ğŸ‡¬ğŸ‡²
:flag_gn	ğŸ‡¬ğŸ‡³
:flag_gp	ğŸ‡¬ğŸ‡µ
:flag_gq	ğŸ‡¬ğŸ‡¶
:flag_gr	ğŸ‡¬ğŸ‡·
:flag_gs	ğŸ‡¬ğŸ‡¸
:flag_gt	ğŸ‡¬ğŸ‡¹
:flag_gu	ğŸ‡¬ğŸ‡º
:flag_gw	ğŸ‡¬ğŸ‡¼
:flag_gy	ğŸ‡¬ğŸ‡¾
:flag_hk	ğŸ‡­ğŸ‡°
:flag_hm	ğŸ‡­ğŸ‡²
:flag_hn	ğŸ‡­ğŸ‡³
:flag_hr	ğŸ‡­ğŸ‡·
:flag_ht	ğŸ‡­ğŸ‡¹
:flag_hu	ğŸ‡­ğŸ‡º
:flag_ic	ğŸ‡®ğŸ‡¨
:flag_id	ğŸ‡®ğŸ‡©
:flag_ie	ğŸ‡®ğŸ‡ª
:flag_il	ğŸ‡®ğŸ‡±
:flag_im	ğŸ‡®ğŸ‡²
:flag_in	ğŸ‡®ğŸ‡³
:flag_io	ğŸ‡®ğŸ‡´
:flag_iq	ğŸ‡®ğŸ‡¶
:flag_ir	ğŸ‡®ğŸ‡·
:flag_is	ğŸ‡®ğŸ‡¸
:flag_it	ğŸ‡®ğŸ‡¹
:flag_je	ğŸ‡¯ğŸ‡ª
:flag_jm	ğŸ‡¯ğŸ‡²
:flag_jo	ğŸ‡¯ğŸ‡´
:flag_jp	ğŸ‡¯ğŸ‡µ
:flag_ke	ğŸ‡°ğŸ‡ª
:flag_kg	ğŸ‡°ğŸ‡¬
:flag_kh	ğŸ‡°ğŸ‡­
:flag_ki	ğŸ‡°ğŸ‡®
:flag_km	ğŸ‡°ğŸ‡²
:flag_kn	ğŸ‡°ğŸ‡³
:flag_kp	ğŸ‡°ğŸ‡µ
:flag_kr	ğŸ‡°ğŸ‡·
:flag_kw	ğŸ‡°ğŸ‡¼
:flag_ky	ğŸ‡°ğŸ‡¾
:flag_kz	ğŸ‡°ğŸ‡¿
:flag_la	ğŸ‡±ğŸ‡¦
:flag_lb	ğŸ‡±ğŸ‡§
:flag_lc	ğŸ‡±ğŸ‡¨
:flag_li	ğŸ‡±ğŸ‡®
:flag_lk	ğŸ‡±ğŸ‡°
:flag_lr	ğŸ‡±ğŸ‡·
:flag_ls	ğŸ‡±ğŸ‡¸
:flag_lt	ğŸ‡±ğŸ‡¹
:flag_lu	ğŸ‡±ğŸ‡º
:flag_lv	ğŸ‡±ğŸ‡»
:flag_ly	ğŸ‡±ğŸ‡¾
:flag_ma	ğŸ‡²ğŸ‡¦
:flag_mc	ğŸ‡²ğŸ‡¨
:flag_md	ğŸ‡²ğŸ‡©
:flag_me	ğŸ‡²ğŸ‡ª
:flag_mf	ğŸ‡²ğŸ‡«
:flag_mg	ğŸ‡²ğŸ‡¬
:flag_mh	ğŸ‡²ğŸ‡­
:flag_mk	ğŸ‡²ğŸ‡°
:flag_ml	ğŸ‡²ğŸ‡±
:flag_mm	ğŸ‡²ğŸ‡²
:flag_mn	ğŸ‡²ğŸ‡³
:flag_mo	ğŸ‡²ğŸ‡´
:flag_mp	ğŸ‡²ğŸ‡µ
:flag_mq	ğŸ‡²ğŸ‡¶
:flag_mr	ğŸ‡²ğŸ‡·
:flag_ms	ğŸ‡²ğŸ‡¸
:flag_mt	ğŸ‡²ğŸ‡¹
:flag_mu	ğŸ‡²ğŸ‡º
:flag_mv	ğŸ‡²ğŸ‡»
:flag_mw	ğŸ‡²ğŸ‡¼
:flag_mx	ğŸ‡²ğŸ‡½
:flag_my	ğŸ‡²ğŸ‡¾
:flag_mz	ğŸ‡²ğŸ‡¿
:flag_na	ğŸ‡³ğŸ‡¦
:flag_nc	ğŸ‡³ğŸ‡¨
:flag_ne	ğŸ‡³ğŸ‡ª
:flag_nf	ğŸ‡³ğŸ‡«
:flag_ng	ğŸ‡³ğŸ‡¬
:flag_ni	ğŸ‡³ğŸ‡®
:flag_nl	ğŸ‡³ğŸ‡±
:flag_no	ğŸ‡³ğŸ‡´
:flag_np	ğŸ‡³ğŸ‡µ
:flag_nr	ğŸ‡³ğŸ‡·
:flag_nu	ğŸ‡³ğŸ‡º
:flag_nz	ğŸ‡³ğŸ‡¿
:flag_om	ğŸ‡´ğŸ‡²
:flag_pa	ğŸ‡µğŸ‡¦
:flag_pe	ğŸ‡µğŸ‡ª
:flag_pf	ğŸ‡µğŸ‡«
:flag_pg	ğŸ‡µğŸ‡¬
:flag_ph	ğŸ‡µğŸ‡­
:flag_pk	ğŸ‡µğŸ‡°
:flag_pl	ğŸ‡µğŸ‡±
:flag_pm	ğŸ‡µğŸ‡²
:flag_pn	ğŸ‡µğŸ‡³
:flag_pr	ğŸ‡µğŸ‡·
:flag_ps	ğŸ‡µğŸ‡¸
:flag_pt	ğŸ‡µğŸ‡¹
:flag_pw	ğŸ‡µğŸ‡¼
:flag_py	ğŸ‡µğŸ‡¾
:flag_qa	ğŸ‡¶ğŸ‡¦
:flag_re	ğŸ‡·ğŸ‡ª
:flag_ro	ğŸ‡·ğŸ‡´
:flag_rs	ğŸ‡·ğŸ‡¸
:flag_ru	ğŸ‡·ğŸ‡º
:flag_rw	ğŸ‡·ğŸ‡¼
:flag_sa	ğŸ‡¸ğŸ‡¦
:flag_sb	ğŸ‡¸ğŸ‡§
:flag_sc	ğŸ‡¸ğŸ‡¨
:flag_sd	ğŸ‡¸ğŸ‡©
:flag_se	ğŸ‡¸ğŸ‡ª
:flag_sg	ğŸ‡¸ğŸ‡¬
:flag_sh	ğŸ‡¸ğŸ‡­
:flag_si	ğŸ‡¸ğŸ‡®
:flag_sj	ğŸ‡¸ğŸ‡¯
:flag_sk	ğŸ‡¸ğŸ‡°
:flag_sl	ğŸ‡¸ğŸ‡±
:flag_sm	ğŸ‡¸ğŸ‡²
:flag_sn	ğŸ‡¸ğŸ‡³
:flag_so	ğŸ‡¸ğŸ‡´
:flag_sr	ğŸ‡¸ğŸ‡·
:flag_ss	ğŸ‡¸ğŸ‡¸
:flag_st	ğŸ‡¸ğŸ‡¹
:flag_sv	ğŸ‡¸ğŸ‡»
:flag_sx	ğŸ‡¸ğŸ‡½
:flag_sy	ğŸ‡¸ğŸ‡¾
:flag_sz	ğŸ‡¸ğŸ‡¿
:flag_ta	ğŸ‡¹ğŸ‡¦
:flag_tc	ğŸ‡¹ğŸ‡¨
:flag_td	ğŸ‡¹ğŸ‡©
:flag_tf	ğŸ‡¹ğŸ‡«
:flag_tg	ğŸ‡¹ğŸ‡¬
:flag_th	ğŸ‡¹ğŸ‡­
:flag_tj	ğŸ‡¹ğŸ‡¯
:flag_tk	ğŸ‡¹ğŸ‡°
:flag_tl	ğŸ‡¹ğŸ‡±
:flag_tm	ğŸ‡¹ğŸ‡²
:flag_tn	ğŸ‡¹ğŸ‡³
:flag_to	ğŸ‡¹ğŸ‡´
:flag_tr	ğŸ‡¹ğŸ‡·
:flag_tt	ğŸ‡¹ğŸ‡¹
:flag_tv	ğŸ‡¹ğŸ‡»
:flag_tw	ğŸ‡¹ğŸ‡¼
:flag_tz	ğŸ‡¹ğŸ‡¿
:flag_ua	ğŸ‡ºğŸ‡¦
:flag_ug	ğŸ‡ºğŸ‡¬
:flag_um	ğŸ‡ºğŸ‡²
:flag_us	ğŸ‡ºğŸ‡¸
:flag_uy	ğŸ‡ºğŸ‡¾
:flag_uz	ğŸ‡ºğŸ‡¿
:flag_va	ğŸ‡»ğŸ‡¦
:flag_vc	ğŸ‡»ğŸ‡¨
:flag_ve	ğŸ‡»ğŸ‡ª
:flag_vg	ğŸ‡»ğŸ‡¬
:flag_vi	ğŸ‡»ğŸ‡®
:flag_vn	ğŸ‡»ğŸ‡³
:flag_vu	ğŸ‡»ğŸ‡º
:flag_wf	ğŸ‡¼ğŸ‡«
:flag_white	ğŸ³
:flag_ws	ğŸ‡¼ğŸ‡¸
:flag_xk	ğŸ‡½ğŸ‡°
:flag_ye	ğŸ‡¾ğŸ‡ª
:flag_yt	ğŸ‡¾ğŸ‡¹
:flag_za	ğŸ‡¿ğŸ‡¦
:flag_zm	ğŸ‡¿ğŸ‡²
:flag_zw	ğŸ‡¿ğŸ‡¼
:flags	ğŸ
:flame	ğŸ”¥
:flan	ğŸ®
:flashlight	ğŸ”¦
:fleur-de-lis	âšœ
:floppy_disk	ğŸ’¾
:flower_playing_cards	ğŸ´
:flushed	ğŸ˜³
:flying_disc	ğŸ¥
:flying_saucer	ğŸ›¸
:fm	ğŸ‡«ğŸ‡²
:fo:	ğŸ‡«ğŸ‡´
:fog:	ğŸŒ«
:foggy	ğŸŒ
:foot:	ğŸ¦¶
:foot_dark_skin_tone	ğŸ¦¶ğŸ¿
:foot_light_skin_tone	ğŸ¦¶ğŸ»
:foot_medium_dark_skin_tone	ğŸ¦¶ğŸ¾
:foot_medium_light_skin_tone	ğŸ¦¶ğŸ¼
:foot_medium_skin_tone	ğŸ¦¶ğŸ½
:foot_tone1	ğŸ¦¶ğŸ»
:foot_tone2	ğŸ¦¶ğŸ¼
:foot_tone3	ğŸ¦¶ğŸ½
:foot_tone4	ğŸ¦¶ğŸ¾
:foot_tone5	ğŸ¦¶ğŸ¿
:football	ğŸˆ
:footprints	ğŸ‘£
:fork_and_knife:	ğŸ´
:fork_and_knife_with_plate	ğŸ½
:fork_knife_plate	ğŸ½
:fortune_cookie	ğŸ¥ 
:fountain	â›²
:four:	4ï¸âƒ£
:four_leaf_clover	ğŸ€
:fox	ğŸ¦Š
:fr:	ğŸ‡«ğŸ‡·
:frame_photo	ğŸ–¼
:frame_with_picture	ğŸ–¼
:free	ğŸ†“
:french_bread	ğŸ¥–
:fried_shrimp	ğŸ¤
:fries	ğŸŸ
:frog	ğŸ¸
:frowning2	â˜¹
:frowning:	ğŸ˜¦
:fuelpump	â›½
:full_moon:	ğŸŒ•
:full_moon_with_face	ğŸŒ
:funeral_urn	âš±
:ga:	ğŸ‡¬ğŸ‡¦
:game_die	ğŸ²
:gay_pride_flag	ğŸ³ï¸â€ğŸŒˆ
:gb	ğŸ‡¬ğŸ‡§
:gd	ğŸ‡¬ğŸ‡©
:ge:	ğŸ‡¬ğŸ‡ª
:gear	âš™
:gem:	ğŸ’
:gemini	â™Š
:genie	ğŸ§
:gf	ğŸ‡¬ğŸ‡«
:gg	ğŸ‡¬ğŸ‡¬
:gh:	ğŸ‡¬ğŸ‡­
:ghost	ğŸ‘»
:gi:	ğŸ‡¬ğŸ‡®
:gift:	ğŸ
:gift_heart	ğŸ’
:giraffe	ğŸ¦’
:girl:	ğŸ‘§
:girl_tone1	ğŸ‘§ğŸ»
:girl_tone2	ğŸ‘§ğŸ¼
:girl_tone3	ğŸ‘§ğŸ½
:girl_tone4	ğŸ‘§ğŸ¾
:girl_tone5	ğŸ‘§ğŸ¿
:gl:	ğŸ‡¬ğŸ‡±
:glass_of_milk	ğŸ¥›
:globe_with_meridians	ğŸŒ
:gloves	ğŸ§¤
:gm	ğŸ‡¬ğŸ‡²
:gn	ğŸ‡¬ğŸ‡³
:goal	ğŸ¥…
:goat	ğŸ
:goggles	ğŸ¥½
:golf:	â›³
:golfer	ğŸŒ
:gorilla	ğŸ¦
:gp	ğŸ‡¬ğŸ‡µ
:gq	ğŸ‡¬ğŸ‡¶
:gr:	ğŸ‡¬ğŸ‡·
:grandma:	ğŸ‘µ
:grandma_tone1	ğŸ‘µğŸ»
:grandma_tone2	ğŸ‘µğŸ¼
:grandma_tone3	ğŸ‘µğŸ½
:grandma_tone4	ğŸ‘µğŸ¾
:grandma_tone5	ğŸ‘µğŸ¿
:grapes	ğŸ‡
:green_apple	ğŸ
:green_book	ğŸ“—
:green_heart	ğŸ’š
:green_salad	ğŸ¥—
:grey_exclamation	â•
:grey_question	â”
:grimacing	ğŸ˜¬
:grin:	ğŸ˜
:grinning	ğŸ˜€
:gs	ğŸ‡¬ğŸ‡¸
:gt	ğŸ‡¬ğŸ‡¹
:gu:	ğŸ‡¬ğŸ‡º
:guard:	ğŸ’‚
:guard_tone1	ğŸ’‚ğŸ»
:guard_tone2	ğŸ’‚ğŸ¼
:guard_tone3	ğŸ’‚ğŸ½
:guard_tone4	ğŸ’‚ğŸ¾
:guard_tone5	ğŸ’‚ğŸ¿
:guardsman_tone1	ğŸ’‚ğŸ»
:guardsman_tone2	ğŸ’‚ğŸ¼
:guardsman_tone3	ğŸ’‚ğŸ½
:guardsman_tone4	ğŸ’‚ğŸ¾
:guardsman_tone5	ğŸ’‚ğŸ¿
:guitar	ğŸ¸
:gun	ğŸ”«
:gw	ğŸ‡¬ğŸ‡¼
:gy	ğŸ‡¬ğŸ‡¾
:haircut:	ğŸ’‡
:haircut_tone1	ğŸ’‡ğŸ»
:haircut_tone2	ğŸ’‡ğŸ¼
:haircut_tone3	ğŸ’‡ğŸ½
:haircut_tone4	ğŸ’‡ğŸ¾
:haircut_tone5	ğŸ’‡ğŸ¿
:hamburger	ğŸ”
:hammer:	ğŸ”¨
:hammer_and_pick	âš’
:hammer_and_wrench	ğŸ› 
:hammer_pick	âš’
:hamster	ğŸ¹
:hand_splayed:	ğŸ–
:hand_splayed_tone1	ğŸ–ğŸ»
:hand_splayed_tone2	ğŸ–ğŸ¼
:hand_splayed_tone3	ğŸ–ğŸ½
:hand_splayed_tone4	ğŸ–ğŸ¾
:hand_splayed_tone5	ğŸ–ğŸ¿
:hand_with_index_and_middle_finger_crossed	ğŸ¤
:hand_with_index_and_middle_fingers_crossed_tone1	ğŸ¤ğŸ»
:hand_with_index_and_middle_fingers_crossed_tone2	ğŸ¤ğŸ¼
:hand_with_index_and_middle_fingers_crossed_tone3	ğŸ¤ğŸ½
:hand_with_index_and_middle_fingers_crossed_tone4	ğŸ¤ğŸ¾
:hand_with_index_and_middle_fingers_crossed_tone5	ğŸ¤ğŸ¿
:handbag	ğŸ‘œ
:handball:	ğŸ¤¾
:handball_tone1	ğŸ¤¾ğŸ»
:handball_tone2	ğŸ¤¾ğŸ¼
:handball_tone3	ğŸ¤¾ğŸ½
:handball_tone4	ğŸ¤¾ğŸ¾
:handball_tone5	ğŸ¤¾ğŸ¿
:handshake	ğŸ¤
:hankey	ğŸ’©
:hash	#ï¸âƒ£
:hatched_chick	ğŸ¥
:hatching_chick	ğŸ£
:head_bandage	ğŸ¤•
:headphones	ğŸ§
:hear_no_evil	ğŸ™‰
:heart:	â¤
:heart_decoration	ğŸ’Ÿ
:heart_exclamation	â£
:heart_eyes:	ğŸ˜
:heart_eyes_cat	ğŸ˜»
:heartbeat	ğŸ’“
:heartpulse	ğŸ’—
:hearts	â™¥
:heavy_check_mark	âœ”
:heavy_division_sign	â—
:heavy_dollar_sign	ğŸ’²
:heavy_heart_exclamation_mark_ornament	â£
:heavy_minus_sign	â–
:heavy_multiplication_x	âœ–
:heavy_plus_sign	â•
:hedgehog	ğŸ¦”
:helicopter	ğŸš
:helmet_with_cross	â›‘
:helmet_with_white_cross	â›‘
:herb	ğŸŒ¿
:hibiscus	ğŸŒº
:high_brightness	ğŸ”†
:high_heel	ğŸ‘ 
:hiking_boot	ğŸ¥¾
:hippopotamus	ğŸ¦›
:hk	ğŸ‡­ğŸ‡°
:hm	ğŸ‡­ğŸ‡²
:hn	ğŸ‡­ğŸ‡³
:hockey	ğŸ’
:hole	ğŸ•³
:homes	ğŸ˜
:honey_pot	ğŸ¯
:horse:	ğŸ´
:horse_racing:	ğŸ‡
:horse_racing_tone1	ğŸ‡ğŸ»
:horse_racing_tone2	ğŸ‡ğŸ¼
:horse_racing_tone3	ğŸ‡ğŸ½
:horse_racing_tone4	ğŸ‡ğŸ¾
:horse_racing_tone5	ğŸ‡ğŸ¿
:hospital	ğŸ¥
:hot_dog	ğŸŒ­
:hot_face	ğŸ¥µ
:hot_pepper	ğŸŒ¶
:hotdog	ğŸŒ­
:hotel	ğŸ¨
:hotsprings	â™¨
:hourglass:	âŒ›
:hourglass_flowing_sand	â³
:house:	ğŸ 
:house_abandoned	ğŸš
:house_buildings	ğŸ˜
:house_with_garden	ğŸ¡
:hr	ğŸ‡­ğŸ‡·
:ht	ğŸ‡­ğŸ‡¹
:hu:	ğŸ‡­ğŸ‡º
:hugging	ğŸ¤—
:hushed	ğŸ˜¯
:ic:	ğŸ‡®ğŸ‡¨
:ice_cream	ğŸ¨
:ice_skate	â›¸
:icecream	ğŸ¦
:id:	ğŸ†”
:ideograph_advantage	ğŸ‰
:ie	ğŸ‡®ğŸ‡ª
:il	ğŸ‡®ğŸ‡±
:im:	ğŸ‡®ğŸ‡²
:imp	ğŸ‘¿
:in:	ğŸ‡®ğŸ‡³
:inbox_tray	ğŸ“¥
:incoming_envelope	ğŸ“¨
:indonesia	ğŸ‡®ğŸ‡©
:infinity	â™¾ï¸
:information_desk_person:	ğŸ’
:information_desk_person_tone1	ğŸ’ğŸ»
:information_desk_person_tone2	ğŸ’ğŸ¼
:information_desk_person_tone3	ğŸ’ğŸ½
:information_desk_person_tone4	ğŸ’ğŸ¾
:information_desk_person_tone5	ğŸ’ğŸ¿
:information_source	â„¹
:innocent	ğŸ˜‡
:interrobang	â‰
:io	ğŸ‡®ğŸ‡´
:iphone	ğŸ“±
:iq	ğŸ‡®ğŸ‡¶
:ir	ğŸ‡®ğŸ‡·
:is:	ğŸ‡®ğŸ‡¸
:island	ğŸ
:it	ğŸ‡®ğŸ‡¹
:izakaya_lantern	ğŸ®
:jack_o_lantern	ğŸƒ
:japan:	ğŸ—¾
:japanese_castle	ğŸ¯
:japanese_goblin	ğŸ‘º
:japanese_ogre	ğŸ‘¹
:je:	ğŸ‡¯ğŸ‡ª
:jeans	ğŸ‘–
:jigsaw	ğŸ§©
:jm	ğŸ‡¯ğŸ‡²
:jo:	ğŸ‡¯ğŸ‡´
:joy:	ğŸ˜‚
:joy_cat	ğŸ˜¹
:joystick	ğŸ•¹
:jp	ğŸ‡¯ğŸ‡µ
:juggler:	ğŸ¤¹
:juggler_tone1	ğŸ¤¹ğŸ»
:juggler_tone2	ğŸ¤¹ğŸ¼
:juggler_tone3	ğŸ¤¹ğŸ½
:juggler_tone4	ğŸ¤¹ğŸ¾
:juggler_tone5	ğŸ¤¹ğŸ¿
:juggling:	ğŸ¤¹
:juggling_tone1	ğŸ¤¹ğŸ»
:juggling_tone2	ğŸ¤¹ğŸ¼
:juggling_tone3	ğŸ¤¹ğŸ½
:juggling_tone4	ğŸ¤¹ğŸ¾
:juggling_tone5	ğŸ¤¹ğŸ¿
:kaaba	ğŸ•‹
:kangaroo	ğŸ¦˜
:karate_uniform	ğŸ¥‹
:kayak	ğŸ›¶
:ke:	ğŸ‡°ğŸ‡ª
:key2	ğŸ—
:key:	ğŸ”‘
:keyboard	âŒ¨
:keycap_asterisk	*ï¸âƒ£
:keycap_ten	ğŸ”Ÿ
:kg	ğŸ‡°ğŸ‡¬
:kh	ğŸ‡°ğŸ‡­
:ki:	ğŸ‡°ğŸ‡®
:kimono	ğŸ‘˜
:kiss:	ğŸ’‹
:kissing:	ğŸ˜—
:kissing_cat	ğŸ˜½
:kissing_closed_eyes	ğŸ˜š
:kissing_heart	ğŸ˜˜
:kissing_smiling_eyes	ğŸ˜™
:kiwi	ğŸ¥
:km	ğŸ‡°ğŸ‡²
:kn:	ğŸ‡°ğŸ‡³
:knife	ğŸ”ª
:koala	ğŸ¨
:koko	ğŸˆ
:kp	ğŸ‡°ğŸ‡µ
:kr	ğŸ‡°ğŸ‡·
:kw	ğŸ‡°ğŸ‡¼
:ky	ğŸ‡°ğŸ‡¾
:kz	ğŸ‡°ğŸ‡¿
:la:	ğŸ‡±ğŸ‡¦
:lab_coat	ğŸ¥¼
:label	ğŸ·
:lacrosse	ğŸ¥
:large_blue_diamond	ğŸ”·
:large_orange_diamond	ğŸ”¶
:last_quarter_moon:	ğŸŒ—
:last_quarter_moon_with_face	ğŸŒœ
:latin_cross	âœ
:laughing	ğŸ˜†
:lb	ğŸ‡±ğŸ‡§
:lc	ğŸ‡±ğŸ‡¨
:leafy_green	ğŸ¥¬
:leaves	ğŸƒ
:ledger	ğŸ“’
:left_facing_fist:	ğŸ¤›
:left_facing_fist_tone1	ğŸ¤›ğŸ»
:left_facing_fist_tone2	ğŸ¤›ğŸ¼
:left_facing_fist_tone3	ğŸ¤›ğŸ½
:left_facing_fist_tone4	ğŸ¤›ğŸ¾
:left_facing_fist_tone5	ğŸ¤›ğŸ¿
:left_fist:	ğŸ¤›
:left_fist_tone1	ğŸ¤›ğŸ»
:left_fist_tone2	ğŸ¤›ğŸ¼
:left_fist_tone3	ğŸ¤›ğŸ½
:left_fist_tone4	ğŸ¤›ğŸ¾
:left_fist_tone5	ğŸ¤›ğŸ¿
:left_luggage	ğŸ›…
:left_right_arrow	â†”
:left_speech_bubble	ğŸ—¨
:leftwards_arrow_with_hook	â†©
:leg:	ğŸ¦µ
:leg_dark_skin_tone	ğŸ¦µğŸ¿
:leg_light_skin_tone	ğŸ¦µğŸ»
:leg_medium_dark_skin_tone	ğŸ¦µğŸ¾
:leg_medium_light_skin_tone	ğŸ¦µğŸ¼
:leg_medium_skin_tone	ğŸ¦µğŸ½
:leg_tone1	ğŸ¦µğŸ»
:leg_tone2	ğŸ¦µğŸ¼
:leg_tone3	ğŸ¦µğŸ½
:leg_tone4	ğŸ¦µğŸ¾
:leg_tone5	ğŸ¦µğŸ¿
:lemon	ğŸ‹
:leo:	â™Œ
:leopard	ğŸ†
:level_slider	ğŸš
:levitate:	ğŸ•´
:levitate_tone1	ğŸ•´ğŸ»
:levitate_tone2	ğŸ•´ğŸ¼
:levitate_tone3	ğŸ•´ğŸ½
:levitate_tone4	ğŸ•´ğŸ¾
:levitate_tone5	ğŸ•´ğŸ¿
:li:	ğŸ‡±ğŸ‡®
:liar	ğŸ¤¥
:libra	â™
:lifter:	ğŸ‹
:lifter_tone1	ğŸ‹ğŸ»
:lifter_tone2	ğŸ‹ğŸ¼
:lifter_tone3	ğŸ‹ğŸ½
:lifter_tone4	ğŸ‹ğŸ¾
:lifter_tone5	ğŸ‹ğŸ¿
:light_rail	ğŸšˆ
:link:	ğŸ”—
:linked_paperclips	ğŸ–‡
:lion:	ğŸ¦
:lion_face	ğŸ¦
:lips:	ğŸ‘„
:lipstick	ğŸ’„
:lizard	ğŸ¦
:lk	ğŸ‡±ğŸ‡°
:llama	ğŸ¦™
:lobster	ğŸ¦
:lock:	ğŸ”’
:lock_with_ink_pen	ğŸ”
:lollipop	ğŸ­
:loop	â¿
:loud_sound	ğŸ”Š
:loudspeaker	ğŸ“¢
:love_hotel	ğŸ©
:love_letter	ğŸ’Œ
:love_you_gesture:	ğŸ¤Ÿ
:love_you_gesture_dark_skin_tone	ğŸ¤ŸğŸ¿
:love_you_gesture_light_skin_tone	ğŸ¤ŸğŸ»
:love_you_gesture_medium_dark_skin_tone	ğŸ¤ŸğŸ¾
:love_you_gesture_medium_light_skin_tone	ğŸ¤ŸğŸ¼
:love_you_gesture_medium_skin_tone	ğŸ¤ŸğŸ½
:love_you_gesture_tone1	ğŸ¤ŸğŸ»
:love_you_gesture_tone2	ğŸ¤ŸğŸ¼
:love_you_gesture_tone3	ğŸ¤ŸğŸ½
:love_you_gesture_tone4	ğŸ¤ŸğŸ¾
:love_you_gesture_tone5	ğŸ¤ŸğŸ¿
:low_brightness	ğŸ”…
:lower_left_ballpoint_pen	ğŸ–Š
:lower_left_crayon	ğŸ–
:lower_left_fountain_pen	ğŸ–‹
:lower_left_paintbrush	ğŸ–Œ
:lr	ğŸ‡±ğŸ‡·
:ls	ğŸ‡±ğŸ‡¸
:lt	ğŸ‡±ğŸ‡¹
:lu:	ğŸ‡±ğŸ‡º
:luggage	ğŸ§³
:lv	ğŸ‡±ğŸ‡»
:ly:	ğŸ‡±ğŸ‡¾
:lying_face	ğŸ¤¥
:m:	â“‚
:ma:	ğŸ‡²ğŸ‡¦
:mag:	ğŸ”
:mag_right	ğŸ”
:mage:	ğŸ§™
:mage_dark_skin_tone	ğŸ§™ğŸ¿
:mage_light_skin_tone	ğŸ§™ğŸ»
:mage_medium_dark_skin_tone	ğŸ§™ğŸ¾
:mage_medium_light_skin_tone	ğŸ§™ğŸ¼
:mage_medium_skin_tone	ğŸ§™ğŸ½
:mage_tone1	ğŸ§™ğŸ»
:mage_tone2	ğŸ§™ğŸ¼
:mage_tone3	ğŸ§™ğŸ½
:mage_tone4	ğŸ§™ğŸ¾
:mage_tone5	ğŸ§™ğŸ¿
:magnet	ğŸ§²
:mahjong	ğŸ€„
:mailbox:	ğŸ“«
:mailbox_closed	ğŸ“ª
:mailbox_with_mail	ğŸ“¬
:mailbox_with_no_mail	ğŸ“­
:male_dancer:	ğŸ•º
:male_dancer_tone1	ğŸ•ºğŸ»
:male_dancer_tone2	ğŸ•ºğŸ¼
:male_dancer_tone3	ğŸ•ºğŸ½
:male_dancer_tone4	ğŸ•ºğŸ¾
:male_dancer_tone5	ğŸ•ºğŸ¿
:male_sign	â™‚
:man:	ğŸ‘¨
:man_artist:	ğŸ‘¨â€ğŸ¨
:man_artist_dark_skin_tone	ğŸ‘¨ğŸ¿â€ğŸ¨
:man_artist_light_skin_tone	ğŸ‘¨ğŸ»â€ğŸ¨
:man_artist_medium_dark_skin_tone	ğŸ‘¨ğŸ¾â€ğŸ¨
:man_artist_medium_light_skin_tone	ğŸ‘¨ğŸ¼â€ğŸ¨
:man_artist_medium_skin_tone	ğŸ‘¨ğŸ½â€ğŸ¨
:man_artist_tone1	ğŸ‘¨ğŸ»â€ğŸ¨
:man_artist_tone2	ğŸ‘¨ğŸ¼â€ğŸ¨
:man_artist_tone3	ğŸ‘¨ğŸ½â€ğŸ¨
:man_artist_tone4	ğŸ‘¨ğŸ¾â€ğŸ¨
:man_artist_tone5	ğŸ‘¨ğŸ¿â€ğŸ¨
:man_astronaut:	ğŸ‘¨â€ğŸš€
:man_astronaut_dark_skin_tone	ğŸ‘¨ğŸ¿â€ğŸš€
:man_astronaut_light_skin_tone	ğŸ‘¨ğŸ»â€ğŸš€
:man_astronaut_medium_dark_skin_tone	ğŸ‘¨ğŸ¾â€ğŸš€
:man_astronaut_medium_light_skin_tone	ğŸ‘¨ğŸ¼â€ğŸš€
:man_astronaut_medium_skin_tone	ğŸ‘¨ğŸ½â€ğŸš€
:man_astronaut_tone1	ğŸ‘¨ğŸ»â€ğŸš€
:man_astronaut_tone2	ğŸ‘¨ğŸ¼â€ğŸš€
:man_astronaut_tone3	ğŸ‘¨ğŸ½â€ğŸš€
:man_astronaut_tone4	ğŸ‘¨ğŸ¾â€ğŸš€
:man_astronaut_tone5	ğŸ‘¨ğŸ¿â€ğŸš€
:man_bald:	ğŸ‘¨â€ğŸ¦²
:man_bald_dark_skin_tone	ğŸ‘¨ğŸ¿â€ğŸ¦²
:man_bald_light_skin_tone	ğŸ‘¨ğŸ»â€ğŸ¦²
:man_bald_medium_dark_skin_tone	ğŸ‘¨ğŸ¾â€ğŸ¦²
:man_bald_medium_light_skin_tone	ğŸ‘¨ğŸ¼â€ğŸ¦²
:man_bald_medium_skin_tone	ğŸ‘¨ğŸ½â€ğŸ¦²
:man_bald_tone1	ğŸ‘¨ğŸ»â€ğŸ¦²
:man_bald_tone2	ğŸ‘¨ğŸ¼â€ğŸ¦²
:man_bald_tone3	ğŸ‘¨ğŸ½â€ğŸ¦²
:man_bald_tone4	ğŸ‘¨ğŸ¾â€ğŸ¦²
:man_bald_tone5	ğŸ‘¨ğŸ¿â€ğŸ¦²
:man_biking	ğŸš´â€â™‚ï¸
:man_bowing	ğŸ™‡â€â™‚ï¸
:man_cartwheeling	ğŸ¤¸â€â™‚ï¸
:man_climbing	ğŸ§—â€â™‚ï¸
:man_construction_worker	ğŸ‘·â€â™‚ï¸
:man_cook:	ğŸ‘¨â€ğŸ³
:man_cook_dark_skin_tone	ğŸ‘¨ğŸ¿â€ğŸ³
:man_cook_light_skin_tone	ğŸ‘¨ğŸ»â€ğŸ³
:man_cook_medium_dark_skin_tone	ğŸ‘¨ğŸ¾â€ğŸ³
:man_cook_medium_light_skin_tone	ğŸ‘¨ğŸ¼â€ğŸ³
:man_cook_medium_skin_tone	ğŸ‘¨ğŸ½â€ğŸ³
:man_cook_tone1	ğŸ‘¨ğŸ»â€ğŸ³
:man_cook_tone2	ğŸ‘¨ğŸ¼â€ğŸ³
:man_cook_tone3	ğŸ‘¨ğŸ½â€ğŸ³
:man_cook_tone4	ğŸ‘¨ğŸ¾â€ğŸ³
:man_cook_tone5	ğŸ‘¨ğŸ¿â€ğŸ³
:man_curly_haired:	ğŸ‘¨â€ğŸ¦±
:man_curly_haired_dark_skin_tone	ğŸ‘¨ğŸ¿â€ğŸ¦±
:man_curly_haired_light_skin_tone	ğŸ‘¨ğŸ»â€ğŸ¦±
:man_curly_haired_medium_dark_skin_tone	ğŸ‘¨ğŸ¾â€ğŸ¦±
:man_curly_haired_medium_light_skin_tone	ğŸ‘¨ğŸ¼â€ğŸ¦±
:man_curly_haired_medium_skin_tone	ğŸ‘¨ğŸ½â€ğŸ¦±
:man_curly_haired_tone1	ğŸ‘¨ğŸ»â€ğŸ¦±
:man_curly_haired_tone2	ğŸ‘¨ğŸ¼â€ğŸ¦±
:man_curly_haired_tone3	ğŸ‘¨ğŸ½â€ğŸ¦±
:man_curly_haired_tone4	ğŸ‘¨ğŸ¾â€ğŸ¦±
:man_curly_haired_tone5	ğŸ‘¨ğŸ¿â€ğŸ¦±
:man_dancing:	ğŸ•º
:man_dancing_tone1	ğŸ•ºğŸ»
:man_dancing_tone2	ğŸ•ºğŸ¼
:man_dancing_tone3	ğŸ•ºğŸ½
:man_dancing_tone4	ğŸ•ºğŸ¾
:man_dancing_tone5	ğŸ•ºğŸ¿
:man_elf	ğŸ§â€â™‚ï¸
:man_facepalming	ğŸ¤¦â€â™‚ï¸
:man_factory_worker:	ğŸ‘¨â€ğŸ­
:man_factory_worker_dark_skin_tone	ğŸ‘¨ğŸ¿â€ğŸ­
:man_factory_worker_light_skin_tone	ğŸ‘¨ğŸ»â€ğŸ­
:man_factory_worker_medium_dark_skin_tone	ğŸ‘¨ğŸ¾â€ğŸ­
:man_factory_worker_medium_light_skin_tone	ğŸ‘¨ğŸ¼â€ğŸ­
:man_factory_worker_medium_skin_tone	ğŸ‘¨ğŸ½â€ğŸ­
:man_factory_worker_tone1	ğŸ‘¨ğŸ»â€ğŸ­
:man_factory_worker_tone2	ğŸ‘¨ğŸ¼â€ğŸ­
:man_factory_worker_tone3	ğŸ‘¨ğŸ½â€ğŸ­
:man_factory_worker_tone4	ğŸ‘¨ğŸ¾â€ğŸ­
:man_factory_worker_tone5	ğŸ‘¨ğŸ¿â€ğŸ­
:man_fairy	ğŸ§šâ€â™‚ï¸
:man_farmer:	ğŸ‘¨â€ğŸŒ¾
:man_farmer_dark_skin_tone	ğŸ‘¨ğŸ¿â€ğŸŒ¾
:man_farmer_light_skin_tone	ğŸ‘¨ğŸ»â€ğŸŒ¾
:man_farmer_medium_dark_skin_tone	ğŸ‘¨ğŸ¾â€ğŸŒ¾
:man_farmer_medium_light_skin_tone	ğŸ‘¨ğŸ¼â€ğŸŒ¾
:man_farmer_medium_skin_tone	ğŸ‘¨ğŸ½â€ğŸŒ¾
:man_farmer_tone1	ğŸ‘¨ğŸ»â€ğŸŒ¾
:man_farmer_tone2	ğŸ‘¨ğŸ¼â€ğŸŒ¾
:man_farmer_tone3	ğŸ‘¨ğŸ½â€ğŸŒ¾
:man_farmer_tone4	ğŸ‘¨ğŸ¾â€ğŸŒ¾
:man_farmer_tone5	ğŸ‘¨ğŸ¿â€ğŸŒ¾
:man_firefighter:	ğŸ‘¨â€ğŸš’
:man_firefighter_dark_skin_tone	ğŸ‘¨ğŸ¿â€ğŸš’
:man_firefighter_light_skin_tone	ğŸ‘¨ğŸ»â€ğŸš’
:man_firefighter_medium_dark_skin_tone	ğŸ‘¨ğŸ¾â€ğŸš’
:man_firefighter_medium_light_skin_tone	ğŸ‘¨ğŸ¼â€ğŸš’
:man_firefighter_medium_skin_tone	ğŸ‘¨ğŸ½â€ğŸš’
:man_firefighter_tone1	ğŸ‘¨ğŸ»â€ğŸš’
:man_firefighter_tone2	ğŸ‘¨ğŸ¼â€ğŸš’
:man_firefighter_tone3	ğŸ‘¨ğŸ½â€ğŸš’
:man_firefighter_tone4	ğŸ‘¨ğŸ¾â€ğŸš’
:man_firefighter_tone5	ğŸ‘¨ğŸ¿â€ğŸš’
:man_frowning	ğŸ™â€â™‚ï¸
:man_genie	ğŸ§â€â™‚ï¸
:man_gesturing_no	ğŸ™…â€â™‚ï¸
:man_gesturing_ok	ğŸ™†â€â™‚ï¸
:man_getting_face_massage	ğŸ’†â€â™‚ï¸
:man_getting_haircut	ğŸ’‡â€â™‚ï¸
:man_guard	ğŸ’‚â€â™‚ï¸
:man_health_worker	ğŸ‘¨â€âš•ï¸
:man_in_business_suit_levitating:	ğŸ•´
:man_in_business_suit_levitating_dark_skin_tone	ğŸ•´ğŸ¿
:man_in_business_suit_levitating_light_skin_tone	ğŸ•´ğŸ»
:man_in_business_suit_levitating_medium_dark_skin_tone	ğŸ•´ğŸ¾
:man_in_business_suit_levitating_medium_light_skin_tone	ğŸ•´ğŸ¼
:man_in_business_suit_levitating_medium_skin_tone	ğŸ•´ğŸ½
:man_in_business_suit_levitating_tone1	ğŸ•´ğŸ»
:man_in_business_suit_levitating_tone2	ğŸ•´ğŸ¼
:man_in_business_suit_levitating_tone3	ğŸ•´ğŸ½
:man_in_business_suit_levitating_tone4	ğŸ•´ğŸ¾
:man_in_business_suit_levitating_tone5	ğŸ•´ğŸ¿
:man_in_lotus_position	ğŸ§˜â€â™‚ï¸
:man_in_steamy_room	ğŸ§–â€â™‚ï¸
:man_in_tuxedo:	ğŸ¤µ
:man_in_tuxedo_tone1	ğŸ¤µğŸ»
:man_in_tuxedo_tone2	ğŸ¤µğŸ¼
:man_in_tuxedo_tone3	ğŸ¤µğŸ½
:man_in_tuxedo_tone4	ğŸ¤µğŸ¾
:man_in_tuxedo_tone5	ğŸ¤µğŸ¿
:man_judge	ğŸ‘¨â€âš–ï¸
:man_juggling	ğŸ¤¹â€â™‚ï¸
:man_mage	ğŸ§™â€â™‚ï¸
:man_mechanic:	ğŸ‘¨â€ğŸ”§
:man_mechanic_dark_skin_tone	ğŸ‘¨ğŸ¿â€ğŸ”§
:man_mechanic_light_skin_tone	ğŸ‘¨ğŸ»â€ğŸ”§
:man_mechanic_medium_dark_skin_tone	ğŸ‘¨ğŸ¾â€ğŸ”§
:man_mechanic_medium_light_skin_tone	ğŸ‘¨ğŸ¼â€ğŸ”§
:man_mechanic_medium_skin_tone	ğŸ‘¨ğŸ½â€ğŸ”§
:man_mechanic_tone1	ğŸ‘¨ğŸ»â€ğŸ”§
:man_mechanic_tone2	ğŸ‘¨ğŸ¼â€ğŸ”§
:man_mechanic_tone3	ğŸ‘¨ğŸ½â€ğŸ”§
:man_mechanic_tone4	ğŸ‘¨ğŸ¾â€ğŸ”§
:man_mechanic_tone5	ğŸ‘¨ğŸ¿â€ğŸ”§
:man_mountain_biking	ğŸšµâ€â™‚ï¸
:man_office_worker:	ğŸ‘¨â€ğŸ’¼
:man_office_worker_dark_skin_tone	ğŸ‘¨ğŸ¿â€ğŸ’¼
:man_office_worker_light_skin_tone	ğŸ‘¨ğŸ»â€ğŸ’¼
:man_office_worker_medium_dark_skin_tone	ğŸ‘¨ğŸ¾â€ğŸ’¼
:man_office_worker_medium_light_skin_tone	ğŸ‘¨ğŸ¼â€ğŸ’¼
:man_office_worker_medium_skin_tone	ğŸ‘¨ğŸ½â€ğŸ’¼
:man_office_worker_tone1	ğŸ‘¨ğŸ»â€ğŸ’¼
:man_office_worker_tone2	ğŸ‘¨ğŸ¼â€ğŸ’¼
:man_office_worker_tone3	ğŸ‘¨ğŸ½â€ğŸ’¼
:man_office_worker_tone4	ğŸ‘¨ğŸ¾â€ğŸ’¼
:man_office_worker_tone5	ğŸ‘¨ğŸ¿â€ğŸ’¼
:man_pilot	ğŸ‘¨â€âœˆï¸
:man_playing_handball	ğŸ¤¾â€â™‚ï¸
:man_playing_water_polo	ğŸ¤½â€â™‚ï¸
:man_police_officer	ğŸ‘®â€â™‚ï¸
:man_pouting	ğŸ™â€â™‚ï¸
:man_raising_hand	ğŸ™‹â€â™‚ï¸
:man_red_haired:	ğŸ‘¨â€ğŸ¦°
:man_red_haired_dark_skin_tone	ğŸ‘¨ğŸ¿â€ğŸ¦°
:man_red_haired_light_skin_tone	ğŸ‘¨ğŸ»â€ğŸ¦°
:man_red_haired_medium_dark_skin_tone	ğŸ‘¨ğŸ¾â€ğŸ¦°
:man_red_haired_medium_light_skin_tone	ğŸ‘¨ğŸ¼â€ğŸ¦°
:man_red_haired_medium_skin_tone	ğŸ‘¨ğŸ½â€ğŸ¦°
:man_red_haired_tone1	ğŸ‘¨ğŸ»â€ğŸ¦°
:man_red_haired_tone2	ğŸ‘¨ğŸ¼â€ğŸ¦°
:man_red_haired_tone3	ğŸ‘¨ğŸ½â€ğŸ¦°
:man_red_haired_tone4	ğŸ‘¨ğŸ¾â€ğŸ¦°
:man_red_haired_tone5	ğŸ‘¨ğŸ¿â€ğŸ¦°
:man_rowing_boat	ğŸš£â€â™‚ï¸
:man_running	ğŸƒâ€â™‚ï¸
:man_scientist:	ğŸ‘¨â€ğŸ”¬
:man_scientist_dark_skin_tone	ğŸ‘¨ğŸ¿â€ğŸ”¬
:man_scientist_light_skin_tone	ğŸ‘¨ğŸ»â€ğŸ”¬
:man_scientist_medium_dark_skin_tone	ğŸ‘¨ğŸ¾â€ğŸ”¬
:man_scientist_medium_light_skin_tone	ğŸ‘¨ğŸ¼â€ğŸ”¬
:man_scientist_medium_skin_tone	ğŸ‘¨ğŸ½â€ğŸ”¬
:man_scientist_tone1	ğŸ‘¨ğŸ»â€ğŸ”¬
:man_scientist_tone2	ğŸ‘¨ğŸ¼â€ğŸ”¬
:man_scientist_tone3	ğŸ‘¨ğŸ½â€ğŸ”¬
:man_scientist_tone4	ğŸ‘¨ğŸ¾â€ğŸ”¬
:man_scientist_tone5	ğŸ‘¨ğŸ¿â€ğŸ”¬
:man_shrugging	ğŸ¤·â€â™‚ï¸
:man_singer:	ğŸ‘¨â€ğŸ¤
:man_singer_dark_skin_tone	ğŸ‘¨ğŸ¿â€ğŸ¤
:man_singer_light_skin_tone	ğŸ‘¨ğŸ»â€ğŸ¤
:man_singer_medium_dark_skin_tone	ğŸ‘¨ğŸ¾â€ğŸ¤
:man_singer_medium_light_skin_tone	ğŸ‘¨ğŸ¼â€ğŸ¤
:man_singer_medium_skin_tone	ğŸ‘¨ğŸ½â€ğŸ¤
:man_singer_tone1	ğŸ‘¨ğŸ»â€ğŸ¤
:man_singer_tone2	ğŸ‘¨ğŸ¼â€ğŸ¤
:man_singer_tone3	ğŸ‘¨ğŸ½â€ğŸ¤
:man_singer_tone4	ğŸ‘¨ğŸ¾â€ğŸ¤
:man_singer_tone5	ğŸ‘¨ğŸ¿â€ğŸ¤
:man_student:	ğŸ‘¨â€ğŸ“
:man_student_dark_skin_tone	ğŸ‘¨ğŸ¿â€ğŸ“
:man_student_light_skin_tone	ğŸ‘¨ğŸ»â€ğŸ“
:man_student_medium_dark_skin_tone	ğŸ‘¨ğŸ¾â€ğŸ“
:man_student_medium_light_skin_tone	ğŸ‘¨ğŸ¼â€ğŸ“
:man_student_medium_skin_tone	ğŸ‘¨ğŸ½â€ğŸ“
:man_student_tone1	ğŸ‘¨ğŸ»â€ğŸ“
:man_student_tone2	ğŸ‘¨ğŸ¼â€ğŸ“
:man_student_tone3	ğŸ‘¨ğŸ½â€ğŸ“
:man_student_tone4	ğŸ‘¨ğŸ¾â€ğŸ“
:man_student_tone5	ğŸ‘¨ğŸ¿â€ğŸ“
:man_superhero	ğŸ¦¸â€â™‚ï¸
:man_supervillain	ğŸ¦¹â€â™‚ï¸
:man_surfing	ğŸ„â€â™‚ï¸
:man_swimming	ğŸŠâ€â™‚ï¸
:man_teacher:	ğŸ‘¨â€ğŸ«
:man_teacher_dark_skin_tone	ğŸ‘¨ğŸ¿â€ğŸ«
:man_teacher_light_skin_tone	ğŸ‘¨ğŸ»â€ğŸ«
:man_teacher_medium_dark_skin_tone	ğŸ‘¨ğŸ¾â€ğŸ«
:man_teacher_medium_light_skin_tone	ğŸ‘¨ğŸ¼â€ğŸ«
:man_teacher_medium_skin_tone	ğŸ‘¨ğŸ½â€ğŸ«
:man_teacher_tone1	ğŸ‘¨ğŸ»â€ğŸ«
:man_teacher_tone2	ğŸ‘¨ğŸ¼â€ğŸ«
:man_teacher_tone3	ğŸ‘¨ğŸ½â€ğŸ«
:man_teacher_tone4	ğŸ‘¨ğŸ¾â€ğŸ«
:man_teacher_tone5	ğŸ‘¨ğŸ¿â€ğŸ«
:man_technologist:	ğŸ‘¨â€ğŸ’»
:man_technologist_dark_skin_tone	ğŸ‘¨ğŸ¿â€ğŸ’»
:man_technologist_light_skin_tone	ğŸ‘¨ğŸ»â€ğŸ’»
:man_technologist_medium_dark_skin_tone	ğŸ‘¨ğŸ¾â€ğŸ’»
:man_technologist_medium_light_skin_tone	ğŸ‘¨ğŸ¼â€ğŸ’»
:man_technologist_medium_skin_tone	ğŸ‘¨ğŸ½â€ğŸ’»
:man_technologist_tone1	ğŸ‘¨ğŸ»â€ğŸ’»
:man_technologist_tone2	ğŸ‘¨ğŸ¼â€ğŸ’»
:man_technologist_tone3	ğŸ‘¨ğŸ½â€ğŸ’»
:man_technologist_tone4	ğŸ‘¨ğŸ¾â€ğŸ’»
:man_technologist_tone5	ğŸ‘¨ğŸ¿â€ğŸ’»
:man_tipping_hand	ğŸ’â€â™‚ï¸
:man_tone1	ğŸ‘¨ğŸ»
:man_tone2	ğŸ‘¨ğŸ¼
:man_tone3	ğŸ‘¨ğŸ½
:man_tone4	ğŸ‘¨ğŸ¾
:man_tone5	ğŸ‘¨ğŸ¿
:man_vampire	ğŸ§›â€â™‚ï¸
:man_walking	ğŸš¶â€â™‚ï¸
:man_wearing_turban	ğŸ‘³â€â™‚ï¸
:man_white_haired:	ğŸ‘¨â€ğŸ¦³
:man_white_haired_dark_skin_tone	ğŸ‘¨ğŸ¿â€ğŸ¦³
:man_white_haired_light_skin_tone	ğŸ‘¨ğŸ»â€ğŸ¦³
:man_white_haired_medium_dark_skin_tone	ğŸ‘¨ğŸ¾â€ğŸ¦³
:man_white_haired_medium_light_skin_tone	ğŸ‘¨ğŸ¼â€ğŸ¦³
:man_white_haired_medium_skin_tone	ğŸ‘¨ğŸ½â€ğŸ¦³
:man_white_haired_tone1	ğŸ‘¨ğŸ»â€ğŸ¦³
:man_white_haired_tone2	ğŸ‘¨ğŸ¼â€ğŸ¦³
:man_white_haired_tone3	ğŸ‘¨ğŸ½â€ğŸ¦³
:man_white_haired_tone4	ğŸ‘¨ğŸ¾â€ğŸ¦³
:man_white_haired_tone5	ğŸ‘¨ğŸ¿â€ğŸ¦³
:man_with_chinese_cap:	ğŸ‘²
:man_with_chinese_cap_tone1	ğŸ‘²ğŸ»
:man_with_chinese_cap_tone2	ğŸ‘²ğŸ¼
:man_with_chinese_cap_tone3	ğŸ‘²ğŸ½
:man_with_chinese_cap_tone4	ğŸ‘²ğŸ¾
:man_with_chinese_cap_tone5	ğŸ‘²ğŸ¿
:man_with_gua_pi_mao:	ğŸ‘²
:man_with_gua_pi_mao_tone1	ğŸ‘²ğŸ»
:man_with_gua_pi_mao_tone2	ğŸ‘²ğŸ¼
:man_with_gua_pi_mao_tone3	ğŸ‘²ğŸ½
:man_with_gua_pi_mao_tone4	ğŸ‘²ğŸ¾
:man_with_gua_pi_mao_tone5	ğŸ‘²ğŸ¿
:man_with_turban:	ğŸ‘³
:man_with_turban_tone1	ğŸ‘³ğŸ»
:man_with_turban_tone2	ğŸ‘³ğŸ¼
:man_with_turban_tone3	ğŸ‘³ğŸ½
:man_with_turban_tone4	ğŸ‘³ğŸ¾
:man_with_turban_tone5	ğŸ‘³ğŸ¿
:man_zombie	ğŸ§Ÿâ€â™‚ï¸
:mango	ğŸ¥­
:mans_shoe	ğŸ‘
:mantlepiece_clock	ğŸ•°
:map:	ğŸ—º
:maple_leaf	ğŸ
:martial_arts_uniform	ğŸ¥‹
:mask	ğŸ˜·
:massage:	ğŸ’†
:massage_tone1	ğŸ’†ğŸ»
:massage_tone2	ğŸ’†ğŸ¼
:massage_tone3	ğŸ’†ğŸ½
:massage_tone4	ğŸ’†ğŸ¾
:massage_tone5	ğŸ’†ğŸ¿
:mc	ğŸ‡²ğŸ‡¨
:md	ğŸ‡²ğŸ‡©
:me:	ğŸ‡²ğŸ‡ª
:meat_on_bone	ğŸ–
:medal	ğŸ…
:medical_symbol	âš•
:mega	ğŸ“£
:melon	ğŸˆ
:memo	ğŸ“
:men_with_bunny_ears_partying	ğŸ‘¯â€â™‚ï¸
:men_wrestling	ğŸ¤¼â€â™‚ï¸
:menorah	ğŸ•
:mens	ğŸš¹
:mermaid	ğŸ§œâ€â™€ï¸
:merman	ğŸ§œâ€â™‚ï¸
:merperson:	ğŸ§œ
:merperson_dark_skin_tone	ğŸ§œğŸ¿
:merperson_light_skin_tone	ğŸ§œğŸ»
:merperson_medium_dark_skin_tone	ğŸ§œğŸ¾
:merperson_medium_light_skin_tone	ğŸ§œğŸ¼
:merperson_medium_skin_tone	ğŸ§œğŸ½
:merperson_tone1	ğŸ§œğŸ»
:merperson_tone2	ğŸ§œğŸ¼
:merperson_tone3	ğŸ§œğŸ½
:merperson_tone4	ğŸ§œğŸ¾
:merperson_tone5	ğŸ§œğŸ¿
:metal:	ğŸ¤˜
:metal_tone1	ğŸ¤˜ğŸ»
:metal_tone2	ğŸ¤˜ğŸ¼
:metal_tone3	ğŸ¤˜ğŸ½
:metal_tone4	ğŸ¤˜ğŸ¾
:metal_tone5	ğŸ¤˜ğŸ¿
:metro	ğŸš‡
:mf	ğŸ‡²ğŸ‡«
:mg	ğŸ‡²ğŸ‡¬
:mh	ğŸ‡²ğŸ‡­
:microbe	ğŸ¦ 
:microphone2	ğŸ™
:microphone:	ğŸ¤
:microscope	ğŸ”¬
:middle_finger:	ğŸ–•
:middle_finger_tone1	ğŸ–•ğŸ»
:middle_finger_tone2	ğŸ–•ğŸ¼
:middle_finger_tone3	ğŸ–•ğŸ½
:middle_finger_tone4	ğŸ–•ğŸ¾
:middle_finger_tone5	ğŸ–•ğŸ¿
:military_medal	ğŸ–
:milk:	ğŸ¥›
:milky_way	ğŸŒŒ
:minibus	ğŸš
:minidisc	ğŸ’½
:mk	ğŸ‡²ğŸ‡°
:ml	ğŸ‡²ğŸ‡±
:mm	ğŸ‡²ğŸ‡²
:mn	ğŸ‡²ğŸ‡³
:mo:	ğŸ‡²ğŸ‡´
:mobile_phone_off	ğŸ“´
:money_mouth	ğŸ¤‘
:money_with_wings	ğŸ’¸
:moneybag	ğŸ’°
:monkey:	ğŸ’
:monkey_face	ğŸµ
:monorail	ğŸš
:moon_cake	ğŸ¥®
:mortar_board	ğŸ“
:mosque	ğŸ•Œ
:mosquito	ğŸ¦Ÿ
:mother_christmas:	ğŸ¤¶
:mother_christmas_tone1	ğŸ¤¶ğŸ»
:mother_christmas_tone2	ğŸ¤¶ğŸ¼
:mother_christmas_tone3	ğŸ¤¶ğŸ½
:mother_christmas_tone4	ğŸ¤¶ğŸ¾
:mother_christmas_tone5	ğŸ¤¶ğŸ¿
:motor_scooter	ğŸ›µ
:motorbike	ğŸ›µ
:motorboat	ğŸ›¥
:motorcycle	ğŸ
:motorway	ğŸ›£
:mount_fuji	ğŸ—»
:mountain:	â›°
:mountain_bicyclist:	ğŸšµ
:mountain_bicyclist_tone1	ğŸšµğŸ»
:mountain_bicyclist_tone2	ğŸšµğŸ¼
:mountain_bicyclist_tone3	ğŸšµğŸ½
:mountain_bicyclist_tone4	ğŸšµğŸ¾
:mountain_bicyclist_tone5	ğŸšµğŸ¿
:mountain_cableway	ğŸš 
:mountain_railway	ğŸš
:mountain_snow	ğŸ”
:mouse2	ğŸ
:mouse:	ğŸ­
:mouse_three_button	ğŸ–±
:movie_camera	ğŸ¥
:moyai	ğŸ—¿
:mp	ğŸ‡²ğŸ‡µ
:mq	ğŸ‡²ğŸ‡¶
:mr:	ğŸ‡²ğŸ‡·
:mrs_claus:	ğŸ¤¶
:mrs_claus_tone1	ğŸ¤¶ğŸ»
:mrs_claus_tone2	ğŸ¤¶ğŸ¼
:mrs_claus_tone3	ğŸ¤¶ğŸ½
:mrs_claus_tone4	ğŸ¤¶ğŸ¾
:mrs_claus_tone5	ğŸ¤¶ğŸ¿
:ms	ğŸ‡²ğŸ‡¸
:mt	ğŸ‡²ğŸ‡¹
:mu:	ğŸ‡²ğŸ‡º
:muscle:	ğŸ’ª
:muscle_tone1	ğŸ’ªğŸ»
:muscle_tone2	ğŸ’ªğŸ¼
:muscle_tone3	ğŸ’ªğŸ½
:muscle_tone4	ğŸ’ªğŸ¾
:muscle_tone5	ğŸ’ªğŸ¿
:mushroom	ğŸ„
:musical_keyboard	ğŸ¹
:musical_note	ğŸµ
:musical_score	ğŸ¼
:mute	ğŸ”‡
:mv	ğŸ‡²ğŸ‡»
:mw	ğŸ‡²ğŸ‡¼
:mx	ğŸ‡²ğŸ‡½
:my	ğŸ‡²ğŸ‡¾
:mz	ğŸ‡²ğŸ‡¿
:na:	ğŸ‡³ğŸ‡¦
:nail_care:	ğŸ’…
:nail_care_tone1	ğŸ’…ğŸ»
:nail_care_tone2	ğŸ’…ğŸ¼
:nail_care_tone3	ğŸ’…ğŸ½
:nail_care_tone4	ğŸ’…ğŸ¾
:nail_care_tone5	ğŸ’…ğŸ¿
:name_badge	ğŸ“›
:national_park	ğŸ
:nauseated_face	ğŸ¤¢
:nazar_amulet	ğŸ§¿
:nc	ğŸ‡³ğŸ‡¨
:ne:	ğŸ‡³ğŸ‡ª
:necktie	ğŸ‘”
:negative_squared_cross_mark	â
:nerd	ğŸ¤“
:neutral_face	ğŸ˜
:new:	ğŸ†•
:new_moon:	ğŸŒ‘
:new_moon_with_face	ğŸŒš
:newspaper2	ğŸ—
:newspaper:	ğŸ“°
:next_track	â­
:nf	ğŸ‡³ğŸ‡«
:ng	ğŸ†–
:ni:	ğŸ‡³ğŸ‡®
:nigeria	ğŸ‡³ğŸ‡¬
:night_with_stars	ğŸŒƒ
:nine	9ï¸âƒ£
:nl	ğŸ‡³ğŸ‡±
:no:	ğŸ‡³ğŸ‡´
:no_bell	ğŸ”•
:no_bicycles	ğŸš³
:no_entry:	â›”
:no_entry_sign	ğŸš«
:no_good:	ğŸ™…
:no_good_tone1	ğŸ™…ğŸ»
:no_good_tone2	ğŸ™…ğŸ¼
:no_good_tone3	ğŸ™…ğŸ½
:no_good_tone4	ğŸ™…ğŸ¾
:no_good_tone5	ğŸ™…ğŸ¿
:no_mobile_phones	ğŸ“µ
:no_mouth	ğŸ˜¶
:no_pedestrians	ğŸš·
:no_smoking	ğŸš­
:non-potable_water	ğŸš±
:nose:	ğŸ‘ƒ
:nose_tone1	ğŸ‘ƒğŸ»
:nose_tone2	ğŸ‘ƒğŸ¼
:nose_tone3	ğŸ‘ƒğŸ½
:nose_tone4	ğŸ‘ƒğŸ¾
:nose_tone5	ğŸ‘ƒğŸ¿
:notebook:	ğŸ““
:notebook_with_decorative_cover	ğŸ“”
:notepad_spiral	ğŸ—’
:notes	ğŸ¶
:np	ğŸ‡³ğŸ‡µ
:nr	ğŸ‡³ğŸ‡·
:nu:	ğŸ‡³ğŸ‡º
:nut_and_bolt	ğŸ”©
:nz	ğŸ‡³ğŸ‡¿
:o2	ğŸ…¾
:o:	â­•
:ocean	ğŸŒŠ
:octagonal_sign	ğŸ›‘
:octopus	ğŸ™
:oden	ğŸ¢
:office	ğŸ¢
:oil	ğŸ›¢
:ok:	ğŸ†—
:ok_hand:	ğŸ‘Œ
:ok_hand_tone1	ğŸ‘ŒğŸ»
:ok_hand_tone2	ğŸ‘ŒğŸ¼
:ok_hand_tone3	ğŸ‘ŒğŸ½
:ok_hand_tone4	ğŸ‘ŒğŸ¾
:ok_hand_tone5	ğŸ‘ŒğŸ¿
:ok_woman:	ğŸ™†
:ok_woman_tone1	ğŸ™†ğŸ»
:ok_woman_tone2	ğŸ™†ğŸ¼
:ok_woman_tone3	ğŸ™†ğŸ½
:ok_woman_tone4	ğŸ™†ğŸ¾
:ok_woman_tone5	ğŸ™†ğŸ¿
:old_key	ğŸ—
:older_adult:	ğŸ§“
:older_adult_dark_skin_tone	ğŸ§“ğŸ¿
:older_adult_light_skin_tone	ğŸ§“ğŸ»
:older_adult_medium_dark_skin_tone	ğŸ§“ğŸ¾
:older_adult_medium_light_skin_tone	ğŸ§“ğŸ¼
:older_adult_medium_skin_tone	ğŸ§“ğŸ½
:older_adult_tone1	ğŸ§“ğŸ»
:older_adult_tone2	ğŸ§“ğŸ¼
:older_adult_tone3	ğŸ§“ğŸ½
:older_adult_tone4	ğŸ§“ğŸ¾
:older_adult_tone5	ğŸ§“ğŸ¿
:older_man:	ğŸ‘´
:older_man_tone1	ğŸ‘´ğŸ»
:older_man_tone2	ğŸ‘´ğŸ¼
:older_man_tone3	ğŸ‘´ğŸ½
:older_man_tone4	ğŸ‘´ğŸ¾
:older_man_tone5	ğŸ‘´ğŸ¿
:older_woman:	ğŸ‘µ
:older_woman_tone1	ğŸ‘µğŸ»
:older_woman_tone2	ğŸ‘µğŸ¼
:older_woman_tone3	ğŸ‘µğŸ½
:older_woman_tone4	ğŸ‘µğŸ¾
:older_woman_tone5	ğŸ‘µğŸ¿
:om:	ğŸ‡´ğŸ‡²
:om_symbol	ğŸ•‰
:on:	ğŸ”›
:oncoming_automobile	ğŸš˜
:oncoming_bus	ğŸš
:oncoming_police_car	ğŸš”
:oncoming_taxi	ğŸš–
:one	1ï¸âƒ£
:open_file_folder	ğŸ“‚
:open_hands:	ğŸ‘
:open_hands_tone1	ğŸ‘ğŸ»
:open_hands_tone2	ğŸ‘ğŸ¼
:open_hands_tone3	ğŸ‘ğŸ½
:open_hands_tone4	ğŸ‘ğŸ¾
:open_hands_tone5	ğŸ‘ğŸ¿
:open_mouth	ğŸ˜®
:ophiuchus	â›
:orange_book	ğŸ“™
:orange_heart	ğŸ§¡
:orthodox_cross	â˜¦
:outbox_tray	ğŸ“¤
:owl	ğŸ¦‰
:ox	ğŸ‚
:pa:	ğŸ‡µğŸ‡¦
:package	ğŸ“¦
:paella	ğŸ¥˜
:page_facing_up	ğŸ“„
:page_with_curl	ğŸ“ƒ
:pager	ğŸ“Ÿ
:paintbrush	ğŸ–Œ
:palm_tree	ğŸŒ´
:palms_up_together:	ğŸ¤²
:palms_up_together_dark_skin_tone	ğŸ¤²ğŸ¿
:palms_up_together_light_skin_tone	ğŸ¤²ğŸ»
:palms_up_together_medium_dark_skin_tone	ğŸ¤²ğŸ¾
:palms_up_together_medium_light_skin_tone	ğŸ¤²ğŸ¼
:palms_up_together_medium_skin_tone	ğŸ¤²ğŸ½
:palms_up_together_tone1	ğŸ¤²ğŸ»
:palms_up_together_tone2	ğŸ¤²ğŸ¼
:palms_up_together_tone3	ğŸ¤²ğŸ½
:palms_up_together_tone4	ğŸ¤²ğŸ¾
:palms_up_together_tone5	ğŸ¤²ğŸ¿
:pancakes	ğŸ¥
:panda_face	ğŸ¼
:paperclip:	ğŸ“
:paperclips	ğŸ–‡
:park:	ğŸ
:parking	ğŸ…¿
:parrot	ğŸ¦œ
:part_alternation_mark	ã€½
:partly_sunny	â›…
:partying_face	ğŸ¥³
:passenger_ship	ğŸ›³
:passport_control	ğŸ›‚
:pause_button	â¸
:paw_prints	ğŸ¾
:pe:	ğŸ‡µğŸ‡ª
:peace	â˜®
:peach	ğŸ‘
:peacock	ğŸ¦š
:peanuts	ğŸ¥œ
:pear	ğŸ
:pen_ballpoint	ğŸ–Š
:pen_fountain	ğŸ–‹
:pencil2	âœ
:pencil:	ğŸ“
:penguin	ğŸ§
:pensive	ğŸ˜”
:people_with_bunny_ears_partying	ğŸ‘¯
:people_wrestling	ğŸ¤¼
:performing_arts	ğŸ­
:persevere	ğŸ˜£
:person_biking:	ğŸš´
:person_biking_tone1	ğŸš´ğŸ»
:person_biking_tone2	ğŸš´ğŸ¼
:person_biking_tone3	ğŸš´ğŸ½
:person_biking_tone4	ğŸš´ğŸ¾
:person_biking_tone5	ğŸš´ğŸ¿
:person_bouncing_ball:	â›¹
:person_bouncing_ball_tone1	â›¹ğŸ»
:person_bouncing_ball_tone2	â›¹ğŸ¼
:person_bouncing_ball_tone3	â›¹ğŸ½
:person_bouncing_ball_tone4	â›¹ğŸ¾
:person_bouncing_ball_tone5	â›¹ğŸ¿
:person_bowing:	ğŸ™‡
:person_bowing_tone1	ğŸ™‡ğŸ»
:person_bowing_tone2	ğŸ™‡ğŸ¼
:person_bowing_tone3	ğŸ™‡ğŸ½
:person_bowing_tone4	ğŸ™‡ğŸ¾
:person_bowing_tone5	ğŸ™‡ğŸ¿
:person_climbing:	ğŸ§—
:person_climbing_dark_skin_tone	ğŸ§—ğŸ¿
:person_climbing_light_skin_tone	ğŸ§—ğŸ»
:person_climbing_medium_dark_skin_tone	ğŸ§—ğŸ¾
:person_climbing_medium_light_skin_tone	ğŸ§—ğŸ¼
:person_climbing_medium_skin_tone	ğŸ§—ğŸ½
:person_climbing_tone1	ğŸ§—ğŸ»
:person_climbing_tone2	ğŸ§—ğŸ¼
:person_climbing_tone3	ğŸ§—ğŸ½
:person_climbing_tone4	ğŸ§—ğŸ¾
:person_climbing_tone5	ğŸ§—ğŸ¿
:person_doing_cartwheel:	ğŸ¤¸
:person_doing_cartwheel_tone1	ğŸ¤¸ğŸ»
:person_doing_cartwheel_tone2	ğŸ¤¸ğŸ¼
:person_doing_cartwheel_tone3	ğŸ¤¸ğŸ½
:person_doing_cartwheel_tone4	ğŸ¤¸ğŸ¾
:person_doing_cartwheel_tone5	ğŸ¤¸ğŸ¿
:person_facepalming:	ğŸ¤¦
:person_facepalming_tone1	ğŸ¤¦ğŸ»
:person_facepalming_tone2	ğŸ¤¦ğŸ¼
:person_facepalming_tone3	ğŸ¤¦ğŸ½
:person_facepalming_tone4	ğŸ¤¦ğŸ¾
:person_facepalming_tone5	ğŸ¤¦ğŸ¿
:person_fencing	ğŸ¤º
:person_frowning:	ğŸ™
:person_frowning_tone1	ğŸ™ğŸ»
:person_frowning_tone2	ğŸ™ğŸ¼
:person_frowning_tone3	ğŸ™ğŸ½
:person_frowning_tone4	ğŸ™ğŸ¾
:person_frowning_tone5	ğŸ™ğŸ¿
:person_gesturing_no:	ğŸ™…
:person_gesturing_no_tone1	ğŸ™…ğŸ»
:person_gesturing_no_tone2	ğŸ™…ğŸ¼
:person_gesturing_no_tone3	ğŸ™…ğŸ½
:person_gesturing_no_tone4	ğŸ™…ğŸ¾
:person_gesturing_no_tone5	ğŸ™…ğŸ¿
:person_gesturing_ok:	ğŸ™†
:person_gesturing_ok_tone1	ğŸ™†ğŸ»
:person_gesturing_ok_tone2	ğŸ™†ğŸ¼
:person_gesturing_ok_tone3	ğŸ™†ğŸ½
:person_gesturing_ok_tone4	ğŸ™†ğŸ¾
:person_gesturing_ok_tone5	ğŸ™†ğŸ¿
:person_getting_haircut:	ğŸ’‡
:person_getting_haircut_tone1	ğŸ’‡ğŸ»
:person_getting_haircut_tone2	ğŸ’‡ğŸ¼
:person_getting_haircut_tone3	ğŸ’‡ğŸ½
:person_getting_haircut_tone4	ğŸ’‡ğŸ¾
:person_getting_haircut_tone5	ğŸ’‡ğŸ¿
:person_getting_massage:	ğŸ’†
:person_getting_massage_tone1	ğŸ’†ğŸ»
:person_getting_massage_tone2	ğŸ’†ğŸ¼
:person_getting_massage_tone3	ğŸ’†ğŸ½
:person_getting_massage_tone4	ğŸ’†ğŸ¾
:person_getting_massage_tone5	ğŸ’†ğŸ¿
:person_golfing:	ğŸŒ
:person_golfing_dark_skin_tone	ğŸŒğŸ¿
:person_golfing_light_skin_tone	ğŸŒğŸ»
:person_golfing_medium_dark_skin_tone	ğŸŒğŸ¾
:person_golfing_medium_light_skin_tone	ğŸŒğŸ¼
:person_golfing_medium_skin_tone	ğŸŒğŸ½
:person_golfing_tone1	ğŸŒğŸ»
:person_golfing_tone2	ğŸŒğŸ¼
:person_golfing_tone3	ğŸŒğŸ½
:person_golfing_tone4	ğŸŒğŸ¾
:person_golfing_tone5	ğŸŒğŸ¿
:person_in_bed_dark_skin_tone	ğŸ›ŒğŸ¿
:person_in_bed_light_skin_tone	ğŸ›ŒğŸ»
:person_in_bed_medium_dark_skin_tone	ğŸ›ŒğŸ¾
:person_in_bed_medium_light_skin_tone	ğŸ›ŒğŸ¼
:person_in_bed_medium_skin_tone	ğŸ›ŒğŸ½
:person_in_bed_tone1	ğŸ›ŒğŸ»
:person_in_bed_tone2	ğŸ›ŒğŸ¼
:person_in_bed_tone3	ğŸ›ŒğŸ½
:person_in_bed_tone4	ğŸ›ŒğŸ¾
:person_in_bed_tone5	ğŸ›ŒğŸ¿
:person_in_lotus_position:	ğŸ§˜
:person_in_lotus_position_dark_skin_tone	ğŸ§˜ğŸ¿
:person_in_lotus_position_light_skin_tone	ğŸ§˜ğŸ»
:person_in_lotus_position_medium_dark_skin_tone	ğŸ§˜ğŸ¾
:person_in_lotus_position_medium_light_skin_tone	ğŸ§˜ğŸ¼
:person_in_lotus_position_medium_skin_tone	ğŸ§˜ğŸ½
:person_in_lotus_position_tone1	ğŸ§˜ğŸ»
:person_in_lotus_position_tone2	ğŸ§˜ğŸ¼
:person_in_lotus_position_tone3	ğŸ§˜ğŸ½
:person_in_lotus_position_tone4	ğŸ§˜ğŸ¾
:person_in_lotus_position_tone5	ğŸ§˜ğŸ¿
:person_in_steamy_room:	ğŸ§–
:person_in_steamy_room_dark_skin_tone	ğŸ§–ğŸ¿
:person_in_steamy_room_light_skin_tone	ğŸ§–ğŸ»
:person_in_steamy_room_medium_dark_skin_tone	ğŸ§–ğŸ¾
:person_in_steamy_room_medium_light_skin_tone	ğŸ§–ğŸ¼
:person_in_steamy_room_medium_skin_tone	ğŸ§–ğŸ½
:person_in_steamy_room_tone1	ğŸ§–ğŸ»
:person_in_steamy_room_tone2	ğŸ§–ğŸ¼
:person_in_steamy_room_tone3	ğŸ§–ğŸ½
:person_in_steamy_room_tone4	ğŸ§–ğŸ¾
:person_in_steamy_room_tone5	ğŸ§–ğŸ¿
:person_juggling:	ğŸ¤¹
:person_juggling_tone1	ğŸ¤¹ğŸ»
:person_juggling_tone2	ğŸ¤¹ğŸ¼
:person_juggling_tone3	ğŸ¤¹ğŸ½
:person_juggling_tone4	ğŸ¤¹ğŸ¾
:person_juggling_tone5	ğŸ¤¹ğŸ¿
:person_lifting_weights:	ğŸ‹
:person_lifting_weights_tone1	ğŸ‹ğŸ»
:person_lifting_weights_tone2	ğŸ‹ğŸ¼
:person_lifting_weights_tone3	ğŸ‹ğŸ½
:person_lifting_weights_tone4	ğŸ‹ğŸ¾
:person_lifting_weights_tone5	ğŸ‹ğŸ¿
:person_mountain_biking:	ğŸšµ
:person_mountain_biking_tone1	ğŸšµğŸ»
:person_mountain_biking_tone2	ğŸšµğŸ¼
:person_mountain_biking_tone3	ğŸšµğŸ½
:person_mountain_biking_tone4	ğŸšµğŸ¾
:person_mountain_biking_tone5	ğŸšµğŸ¿
:person_playing_handball:	ğŸ¤¾
:person_playing_handball_tone1	ğŸ¤¾ğŸ»
:person_playing_handball_tone2	ğŸ¤¾ğŸ¼
:person_playing_handball_tone3	ğŸ¤¾ğŸ½
:person_playing_handball_tone4	ğŸ¤¾ğŸ¾
:person_playing_handball_tone5	ğŸ¤¾ğŸ¿
:person_playing_water_polo:	ğŸ¤½
:person_playing_water_polo_tone1	ğŸ¤½ğŸ»
:person_playing_water_polo_tone2	ğŸ¤½ğŸ¼
:person_playing_water_polo_tone3	ğŸ¤½ğŸ½
:person_playing_water_polo_tone4	ğŸ¤½ğŸ¾
:person_playing_water_polo_tone5	ğŸ¤½ğŸ¿
:person_pouting:	ğŸ™
:person_pouting_tone1	ğŸ™ğŸ»
:person_pouting_tone2	ğŸ™ğŸ¼
:person_pouting_tone3	ğŸ™ğŸ½
:person_pouting_tone4	ğŸ™ğŸ¾
:person_pouting_tone5	ğŸ™ğŸ¿
:person_raising_hand:	ğŸ™‹
:person_raising_hand_tone1	ğŸ™‹ğŸ»
:person_raising_hand_tone2	ğŸ™‹ğŸ¼
:person_raising_hand_tone3	ğŸ™‹ğŸ½
:person_raising_hand_tone4	ğŸ™‹ğŸ¾
:person_raising_hand_tone5	ğŸ™‹ğŸ¿
:person_rowing_boat:	ğŸš£
:person_rowing_boat_tone1	ğŸš£ğŸ»
:person_rowing_boat_tone2	ğŸš£ğŸ¼
:person_rowing_boat_tone3	ğŸš£ğŸ½
:person_rowing_boat_tone4	ğŸš£ğŸ¾
:person_rowing_boat_tone5	ğŸš£ğŸ¿
:person_running:	ğŸƒ
:person_running_tone1	ğŸƒğŸ»
:person_running_tone2	ğŸƒğŸ¼
:person_running_tone3	ğŸƒğŸ½
:person_running_tone4	ğŸƒğŸ¾
:person_running_tone5	ğŸƒğŸ¿
:person_shrugging:	ğŸ¤·
:person_shrugging_tone1	ğŸ¤·ğŸ»
:person_shrugging_tone2	ğŸ¤·ğŸ¼
:person_shrugging_tone3	ğŸ¤·ğŸ½
:person_shrugging_tone4	ğŸ¤·ğŸ¾
:person_shrugging_tone5	ğŸ¤·ğŸ¿
:person_surfing:	ğŸ„
:person_surfing_tone1	ğŸ„ğŸ»
:person_surfing_tone2	ğŸ„ğŸ¼
:person_surfing_tone3	ğŸ„ğŸ½
:person_surfing_tone4	ğŸ„ğŸ¾
:person_surfing_tone5	ğŸ„ğŸ¿
:person_swimming:	ğŸŠ
:person_swimming_tone1	ğŸŠğŸ»
:person_swimming_tone2	ğŸŠğŸ¼
:person_swimming_tone3	ğŸŠğŸ½
:person_swimming_tone4	ğŸŠğŸ¾
:person_swimming_tone5	ğŸŠğŸ¿
:person_tipping_hand:	ğŸ’
:person_tipping_hand_tone1	ğŸ’ğŸ»
:person_tipping_hand_tone2	ğŸ’ğŸ¼
:person_tipping_hand_tone3	ğŸ’ğŸ½
:person_tipping_hand_tone4	ğŸ’ğŸ¾
:person_tipping_hand_tone5	ğŸ’ğŸ¿
:person_walking:	ğŸš¶
:person_walking_tone1	ğŸš¶ğŸ»
:person_walking_tone2	ğŸš¶ğŸ¼
:person_walking_tone3	ğŸš¶ğŸ½
:person_walking_tone4	ğŸš¶ğŸ¾
:person_walking_tone5	ğŸš¶ğŸ¿
:person_wearing_turban:	ğŸ‘³
:person_wearing_turban_tone1	ğŸ‘³ğŸ»
:person_wearing_turban_tone2	ğŸ‘³ğŸ¼
:person_wearing_turban_tone3	ğŸ‘³ğŸ½
:person_wearing_turban_tone4	ğŸ‘³ğŸ¾
:person_wearing_turban_tone5	ğŸ‘³ğŸ¿
:person_with_ball:	â›¹
:person_with_ball_tone1	â›¹ğŸ»
:person_with_ball_tone2	â›¹ğŸ¼
:person_with_ball_tone3	â›¹ğŸ½
:person_with_ball_tone4	â›¹ğŸ¾
:person_with_ball_tone5	â›¹ğŸ¿
:person_with_blond_hair:	ğŸ‘±
:person_with_blond_hair_tone1	ğŸ‘±ğŸ»
:person_with_blond_hair_tone2	ğŸ‘±ğŸ¼
:person_with_blond_hair_tone3	ğŸ‘±ğŸ½
:person_with_blond_hair_tone4	ğŸ‘±ğŸ¾
:person_with_blond_hair_tone5	ğŸ‘±ğŸ¿
:person_with_pouting_face:	ğŸ™
:person_with_pouting_face_tone1	ğŸ™ğŸ»
:person_with_pouting_face_tone2	ğŸ™ğŸ¼
:person_with_pouting_face_tone3	ğŸ™ğŸ½
:person_with_pouting_face_tone4	ğŸ™ğŸ¾
:person_with_pouting_face_tone5	ğŸ™ğŸ¿
:petri_dish	ğŸ§«
:pf	ğŸ‡µğŸ‡«
:pg	ğŸ‡µğŸ‡¬
:ph	ğŸ‡µğŸ‡­
:pick	â›
:pie	ğŸ¥§
:pig2	ğŸ–
:pig:	ğŸ·
:pig_nose	ğŸ½
:pill	ğŸ’Š
:pineapple	ğŸ
:ping_pong	ğŸ“
:pirate_flag	ğŸ´â€â˜ ï¸
:pisces	â™“
:pizza	ğŸ•
:pk	ğŸ‡µğŸ‡°
:pl:	ğŸ‡µğŸ‡±
:place_of_worship	ğŸ›
:play_pause	â¯
:pleading_face	ğŸ¥º
:pm	ğŸ‡µğŸ‡²
:pn	ğŸ‡µğŸ‡³
:point_down:	ğŸ‘‡
:point_down_tone1	ğŸ‘‡ğŸ»
:point_down_tone2	ğŸ‘‡ğŸ¼
:point_down_tone3	ğŸ‘‡ğŸ½
:point_down_tone4	ğŸ‘‡ğŸ¾
:point_down_tone5	ğŸ‘‡ğŸ¿
:point_left:	ğŸ‘ˆ
:point_left_tone1	ğŸ‘ˆğŸ»
:point_left_tone2	ğŸ‘ˆğŸ¼
:point_left_tone3	ğŸ‘ˆğŸ½
:point_left_tone4	ğŸ‘ˆğŸ¾
:point_left_tone5	ğŸ‘ˆğŸ¿
:point_right:	ğŸ‘‰
:point_right_tone1	ğŸ‘‰ğŸ»
:point_right_tone2	ğŸ‘‰ğŸ¼
:point_right_tone3	ğŸ‘‰ğŸ½
:point_right_tone4	ğŸ‘‰ğŸ¾
:point_right_tone5	ğŸ‘‰ğŸ¿
:point_up:	â˜
:point_up_2:	ğŸ‘†
:point_up_2_tone1	ğŸ‘†ğŸ»
:point_up_2_tone2	ğŸ‘†ğŸ¼
:point_up_2_tone3	ğŸ‘†ğŸ½
:point_up_2_tone4	ğŸ‘†ğŸ¾
:point_up_2_tone5	ğŸ‘†ğŸ¿
:point_up_tone1	â˜ğŸ»
:point_up_tone2	â˜ğŸ¼
:point_up_tone3	â˜ğŸ½
:point_up_tone4	â˜ğŸ¾
:point_up_tone5	â˜ğŸ¿
:police_car	ğŸš“
:police_officer:	ğŸ‘®
:police_officer_tone1	ğŸ‘®ğŸ»
:police_officer_tone2	ğŸ‘®ğŸ¼
:police_officer_tone3	ğŸ‘®ğŸ½
:police_officer_tone4	ğŸ‘®ğŸ¾
:police_officer_tone5	ğŸ‘®ğŸ¿
:poo:	ğŸ’©
:poodle	ğŸ©
:poop	ğŸ’©
:popcorn	ğŸ¿
:post_office	ğŸ£
:postal_horn	ğŸ“¯
:postbox	ğŸ“®
:potable_water	ğŸš°
:potato	ğŸ¥”
:pouch	ğŸ‘
:poultry_leg	ğŸ—
:pound:	ğŸ’·
:pound_symbol	#
:pouting_cat	ğŸ˜¾
:pr:	ğŸ‡µğŸ‡·
:pray:	ğŸ™
:pray_tone1	ğŸ™ğŸ»
:pray_tone2	ğŸ™ğŸ¼
:pray_tone3	ğŸ™ğŸ½
:pray_tone4	ğŸ™ğŸ¾
:pray_tone5	ğŸ™ğŸ¿
:prayer_beads	ğŸ“¿
:pregnant_woman:	ğŸ¤°
:pregnant_woman_tone1	ğŸ¤°ğŸ»
:pregnant_woman_tone2	ğŸ¤°ğŸ¼
:pregnant_woman_tone3	ğŸ¤°ğŸ½
:pregnant_woman_tone4	ğŸ¤°ğŸ¾
:pregnant_woman_tone5	ğŸ¤°ğŸ¿
:pretzel	ğŸ¥¨
:previous_track	â®
:prince:	ğŸ¤´
:prince_tone1	ğŸ¤´ğŸ»
:prince_tone2	ğŸ¤´ğŸ¼
:prince_tone3	ğŸ¤´ğŸ½
:prince_tone4	ğŸ¤´ğŸ¾
:prince_tone5	ğŸ¤´ğŸ¿
:princess:	ğŸ‘¸
:princess_tone1	ğŸ‘¸ğŸ»
:princess_tone2	ğŸ‘¸ğŸ¼
:princess_tone3	ğŸ‘¸ğŸ½
:princess_tone4	ğŸ‘¸ğŸ¾
:princess_tone5	ğŸ‘¸ğŸ¿
:printer	ğŸ–¨
:projector	ğŸ“½
:ps	ğŸ‡µğŸ‡¸
:pt	ğŸ‡µğŸ‡¹
:pudding	ğŸ®
:punch:	ğŸ‘Š
:punch_tone1	ğŸ‘ŠğŸ»
:punch_tone2	ğŸ‘ŠğŸ¼
:punch_tone3	ğŸ‘ŠğŸ½
:punch_tone4	ğŸ‘ŠğŸ¾
:punch_tone5	ğŸ‘ŠğŸ¿
:purple_heart	ğŸ’œ
:purse	ğŸ‘›
:pushpin	ğŸ“Œ
:put_litter_in_its_place	ğŸš®
:pw	ğŸ‡µğŸ‡¼
:py	ğŸ‡µğŸ‡¾
:qa	ğŸ‡¶ğŸ‡¦
:question	â“
:rabbit2	ğŸ‡
:rabbit:	ğŸ°
:raccoon	ğŸ¦
:race_car	ğŸ
:racehorse	ğŸ
:racing_car	ğŸ
:racing_motorcycle	ğŸ
:radio:	ğŸ“»
:radio_button	ğŸ”˜
:radioactive	â˜¢
:rage	ğŸ˜¡
:railroad_track	ğŸ›¤
:railway_car	ğŸšƒ
:railway_track	ğŸ›¤
:rainbow:	ğŸŒˆ
:rainbow_flag	ğŸ³ï¸â€ğŸŒˆ
:raised_back_of_hand:	ğŸ¤š
:raised_back_of_hand_tone1	ğŸ¤šğŸ»
:raised_back_of_hand_tone2	ğŸ¤šğŸ¼
:raised_back_of_hand_tone3	ğŸ¤šğŸ½
:raised_back_of_hand_tone4	ğŸ¤šğŸ¾
:raised_back_of_hand_tone5	ğŸ¤šğŸ¿
:raised_hand:	âœ‹
:raised_hand_tone1	âœ‹ğŸ»
:raised_hand_tone2	âœ‹ğŸ¼
:raised_hand_tone3	âœ‹ğŸ½
:raised_hand_tone4	âœ‹ğŸ¾
:raised_hand_tone5	âœ‹ğŸ¿
:raised_hand_with_fingers_splayed:	ğŸ–
:raised_hand_with_fingers_splayed_tone1	ğŸ–ğŸ»
:raised_hand_with_fingers_splayed_tone2	ğŸ–ğŸ¼
:raised_hand_with_fingers_splayed_tone3	ğŸ–ğŸ½
:raised_hand_with_fingers_splayed_tone4	ğŸ–ğŸ¾
:raised_hand_with_fingers_splayed_tone5	ğŸ–ğŸ¿
:raised_hand_with_part_between_middle_and_ring_fingers:	ğŸ––
:raised_hand_with_part_between_middle_and_ring_fingers_tone1	ğŸ––ğŸ»
:raised_hand_with_part_between_middle_and_ring_fingers_tone2	ğŸ––ğŸ¼
:raised_hand_with_part_between_middle_and_ring_fingers_tone3	ğŸ––ğŸ½
:raised_hand_with_part_between_middle_and_ring_fingers_tone4	ğŸ––ğŸ¾
:raised_hand_with_part_between_middle_and_ring_fingers_tone5	ğŸ––ğŸ¿
:raised_hands:	ğŸ™Œ
:raised_hands_tone1	ğŸ™ŒğŸ»
:raised_hands_tone2	ğŸ™ŒğŸ¼
:raised_hands_tone3	ğŸ™ŒğŸ½
:raised_hands_tone4	ğŸ™ŒğŸ¾
:raised_hands_tone5	ğŸ™ŒğŸ¿
:raising_hand:	ğŸ™‹
:raising_hand_tone1	ğŸ™‹ğŸ»
:raising_hand_tone2	ğŸ™‹ğŸ¼
:raising_hand_tone3	ğŸ™‹ğŸ½
:raising_hand_tone4	ğŸ™‹ğŸ¾
:raising_hand_tone5	ğŸ™‹ğŸ¿
:ram:	ğŸ
:ramen	ğŸœ
:rat	ğŸ€
:re:	ğŸ‡·ğŸ‡ª
:receipt	ğŸ§¾
:record_button	âº
:recycle	â™»
:red_car	ğŸš—
:red_circle	ğŸ”´
:red_envelope	ğŸ§§
:red_haired	ğŸ¦°
:regional_indicator_a	ğŸ‡¦
:regional_indicator_b	ğŸ‡§
:regional_indicator_c	ğŸ‡¨
:regional_indicator_d	ğŸ‡©
:regional_indicator_e	ğŸ‡ª
:regional_indicator_f	ğŸ‡«
:regional_indicator_g	ğŸ‡¬
:regional_indicator_h	ğŸ‡­
:regional_indicator_i	ğŸ‡®
:regional_indicator_j	ğŸ‡¯
:regional_indicator_k	ğŸ‡°
:regional_indicator_l	ğŸ‡±
:regional_indicator_m	ğŸ‡²
:regional_indicator_n	ğŸ‡³
:regional_indicator_o	ğŸ‡´
:regional_indicator_p	ğŸ‡µ
:regional_indicator_q	ğŸ‡¶
:regional_indicator_r	ğŸ‡·
:regional_indicator_s	ğŸ‡¸
:regional_indicator_t	ğŸ‡¹
:regional_indicator_u	ğŸ‡º
:regional_indicator_v	ğŸ‡»
:regional_indicator_w	ğŸ‡¼
:regional_indicator_x	ğŸ‡½
:regional_indicator_y	ğŸ‡¾
:regional_indicator_z	ğŸ‡¿
:registered	Â®
:relaxed	â˜º
:relieved	ğŸ˜Œ
:reminder_ribbon	ğŸ—
:repeat:	ğŸ”
:repeat_one	ğŸ”‚
:restroom	ğŸš»
:reversed_hand_with_middle_finger_extended:	ğŸ–•
:reversed_hand_with_middle_finger_extended_tone1	ğŸ–•ğŸ»
:reversed_hand_with_middle_finger_extended_tone2	ğŸ–•ğŸ¼
:reversed_hand_with_middle_finger_extended_tone3	ğŸ–•ğŸ½
:reversed_hand_with_middle_finger_extended_tone4	ğŸ–•ğŸ¾
:reversed_hand_with_middle_finger_extended_tone5	ğŸ–•ğŸ¿
:revolving_hearts	ğŸ’
:rewind	âª
:rhino	ğŸ¦
:ribbon	ğŸ€
:rice:	ğŸš
:rice_ball	ğŸ™
:rice_cracker	ğŸ˜
:rice_scene	ğŸ‘
:right_anger_bubble	ğŸ—¯
:right_facing_fist:	ğŸ¤œ
:right_facing_fist_tone1	ğŸ¤œğŸ»
:right_facing_fist_tone2	ğŸ¤œğŸ¼
:right_facing_fist_tone3	ğŸ¤œğŸ½
:right_facing_fist_tone4	ğŸ¤œğŸ¾
:right_facing_fist_tone5	ğŸ¤œğŸ¿
:right_fist:	ğŸ¤œ
:right_fist_tone1	ğŸ¤œğŸ»
:right_fist_tone2	ğŸ¤œğŸ¼
:right_fist_tone3	ğŸ¤œğŸ½
:right_fist_tone4	ğŸ¤œğŸ¾
:right_fist_tone5	ğŸ¤œğŸ¿
:ring	ğŸ’
:ro:	ğŸ‡·ğŸ‡´
:robot	ğŸ¤–
:rocket	ğŸš€
:rofl	ğŸ¤£
:roll_of_paper	ğŸ§»
:rolled_up_newspaper	ğŸ—
:roller_coaster	ğŸ¢
:rolling_eyes	ğŸ™„
:rolling_on_the_floor_laughing	ğŸ¤£
:rooster	ğŸ“
:rose:	ğŸŒ¹
:rosette	ğŸµ
:rotating_light	ğŸš¨
:round_pushpin	ğŸ“
:rowboat:	ğŸš£
:rowboat_tone1	ğŸš£ğŸ»
:rowboat_tone2	ğŸš£ğŸ¼
:rowboat_tone3	ğŸš£ğŸ½
:rowboat_tone4	ğŸš£ğŸ¾
:rowboat_tone5	ğŸš£ğŸ¿
:rs	ğŸ‡·ğŸ‡¸
:ru:	ğŸ‡·ğŸ‡º
:rugby_football	ğŸ‰
:runner:	ğŸƒ
:runner_tone1	ğŸƒğŸ»
:runner_tone2	ğŸƒğŸ¼
:runner_tone3	ğŸƒğŸ½
:runner_tone4	ğŸƒğŸ¾
:runner_tone5	ğŸƒğŸ¿
:running_shirt_with_sash	ğŸ½
:rw	ğŸ‡·ğŸ‡¼
:sa:	ğŸˆ‚
:safety_pin	ğŸ§·
:sagittarius	â™
:sailboat	â›µ
:sake	ğŸ¶
:salad	ğŸ¥—
:salt	ğŸ§‚
:sandal	ğŸ‘¡
:sandwich	ğŸ¥ª
:santa:	ğŸ…
:santa_tone1	ğŸ…ğŸ»
:santa_tone2	ğŸ…ğŸ¼
:santa_tone3	ğŸ…ğŸ½
:santa_tone4	ğŸ…ğŸ¾
:santa_tone5	ğŸ…ğŸ¿
:satellite:	ğŸ“¡
:satellite_orbital	ğŸ›°
:satisfied	ğŸ˜†
:saudi:	ğŸ‡¸ğŸ‡¦
:saudiarabia	ğŸ‡¸ğŸ‡¦
:sauropod	ğŸ¦•
:saxophone	ğŸ·
:sb	ğŸ‡¸ğŸ‡§
:sc:	ğŸ‡¸ğŸ‡¨
:scales	âš–
:scarf	ğŸ§£
:school:	ğŸ«
:school_satchel	ğŸ’
:scissors	âœ‚
:scooter	ğŸ›´
:scorpion	ğŸ¦‚
:scorpius	â™
:scream:	ğŸ˜±
:scream_cat	ğŸ™€
:scroll	ğŸ“œ
:sd	ğŸ‡¸ğŸ‡©
:se:	ğŸ‡¸ğŸ‡ª
:seat	ğŸ’º
:second_place	ğŸ¥ˆ
:secret	ãŠ™
:see_no_evil	ğŸ™ˆ
:seedling	ğŸŒ±
:selfie:	ğŸ¤³
:selfie_tone1	ğŸ¤³ğŸ»
:selfie_tone2	ğŸ¤³ğŸ¼
:selfie_tone3	ğŸ¤³ğŸ½
:selfie_tone4	ğŸ¤³ğŸ¾
:selfie_tone5	ğŸ¤³ğŸ¿
:seven	7ï¸âƒ£
:sg	ğŸ‡¸ğŸ‡¬
:sh:	ğŸ‡¸ğŸ‡­
:shaking_hands	ğŸ¤
:shallow_pan_of_food	ğŸ¥˜
:shamrock	â˜˜
:shark	ğŸ¦ˆ
:shaved_ice	ğŸ§
:sheep	ğŸ‘
:shell:	ğŸš
:shelled_peanut	ğŸ¥œ
:shield	ğŸ›¡
:shinto_shrine	â›©
:ship	ğŸš¢
:shirt	ğŸ‘•
:shit	ğŸ’©
:shopping_bags	ğŸ›
:shopping_cart	ğŸ›’
:shopping_trolley	ğŸ›’
:shower	ğŸš¿
:shrimp	ğŸ¦
:shrug:	ğŸ¤·
:shrug_tone1	ğŸ¤·ğŸ»
:shrug_tone2	ğŸ¤·ğŸ¼
:shrug_tone3	ğŸ¤·ğŸ½
:shrug_tone4	ğŸ¤·ğŸ¾
:shrug_tone5	ğŸ¤·ğŸ¿
:shushing_face	ğŸ¤«
:si:	ğŸ‡¸ğŸ‡®
:sick	ğŸ¤¢
:sign_of_the_horns:	ğŸ¤˜
:sign_of_the_horns_tone1	ğŸ¤˜ğŸ»
:sign_of_the_horns_tone2	ğŸ¤˜ğŸ¼
:sign_of_the_horns_tone3	ğŸ¤˜ğŸ½
:sign_of_the_horns_tone4	ğŸ¤˜ğŸ¾
:sign_of_the_horns_tone5	ğŸ¤˜ğŸ¿
:signal_strength	ğŸ“¶
:six:	6ï¸âƒ£
:six_pointed_star	ğŸ”¯
:sj	ğŸ‡¸ğŸ‡¯
:sk:	ğŸ‡¸ğŸ‡°
:skateboard	ğŸ›¹
:skeleton	ğŸ’€
:ski:	ğŸ¿
:skier	â›·
:skull:	ğŸ’€
:skull_and_crossbones	â˜ 
:skull_crossbones	â˜ 
:sl:	ğŸ‡¸ğŸ‡±
:sled	ğŸ›·
:sleeping:	ğŸ˜´
:sleeping_accommodation	ğŸ›Œ
:sleepy	ğŸ˜ª
:sleuth_or_spy:	ğŸ•µ
:sleuth_or_spy_tone1	ğŸ•µğŸ»
:sleuth_or_spy_tone2	ğŸ•µğŸ¼
:sleuth_or_spy_tone3	ğŸ•µğŸ½
:sleuth_or_spy_tone4	ğŸ•µğŸ¾
:sleuth_or_spy_tone5	ğŸ•µğŸ¿
:slight_frown	ğŸ™
:slight_smile	ğŸ™‚
:slightly_frowning_face	ğŸ™
:slightly_smiling_face	ğŸ™‚
:slot_machine	ğŸ°
:sm:	ğŸ‡¸ğŸ‡²
:small_airplane	ğŸ›©
:small_blue_diamond	ğŸ”¹
:small_orange_diamond	ğŸ”¸
:small_red_triangle:	ğŸ”º
:small_red_triangle_down	ğŸ”»
:smile:	ğŸ˜„
:smile_cat	ğŸ˜¸
:smiley:	ğŸ˜ƒ
:smiley_cat	ğŸ˜º
:smiling_face_with_3_hearts	ğŸ¥°
:smiling_imp	ğŸ˜ˆ
:smirk:	ğŸ˜
:smirk_cat	ğŸ˜¼
:smoking	ğŸš¬
:sn:	ğŸ‡¸ğŸ‡³
:snail	ğŸŒ
:snake	ğŸ
:sneeze	ğŸ¤§
:sneezing_face	ğŸ¤§
:snow_capped_mountain	ğŸ”
:snowboarder:	ğŸ‚
:snowboarder_dark_skin_tone	ğŸ‚ğŸ¿
:snowboarder_light_skin_tone	ğŸ‚ğŸ»
:snowboarder_medium_dark_skin_tone	ğŸ‚ğŸ¾
:snowboarder_medium_light_skin_tone	ğŸ‚ğŸ¼
:snowboarder_medium_skin_tone	ğŸ‚ğŸ½
:snowboarder_tone1	ğŸ‚ğŸ»
:snowboarder_tone2	ğŸ‚ğŸ¼
:snowboarder_tone3	ğŸ‚ğŸ½
:snowboarder_tone4	ğŸ‚ğŸ¾
:snowboarder_tone5	ğŸ‚ğŸ¿
:snowflake	â„
:snowman2	â˜ƒ
:snowman:	â›„
:so:	ğŸ‡¸ğŸ‡´
:soap	ğŸ§¼
:sob	ğŸ˜­
:soccer	âš½
:socks	ğŸ§¦
:softball	ğŸ¥
:soon	ğŸ”œ
:sos	ğŸ†˜
:sound	ğŸ”‰
:space_invader	ğŸ‘¾
:spades	â™ 
:spaghetti	ğŸ
:sparkle:	â‡
:sparkler	ğŸ‡
:sparkles	âœ¨
:sparkling_heart	ğŸ’–
:speak_no_evil	ğŸ™Š
:speaker	ğŸ”ˆ
:speaking_head	ğŸ—£
:speech_balloon	ğŸ’¬
:speech_left	ğŸ—¨
:speedboat	ğŸš¤
:spider:	ğŸ•·
:spider_web	ğŸ•¸
:spiral_calendar_pad	ğŸ—“
:spiral_note_pad	ğŸ—’
:sponge	ğŸ§½
:spoon	ğŸ¥„
:sports_medal	ğŸ…
:spy:	ğŸ•µ
:spy_tone1	ğŸ•µğŸ»
:spy_tone2	ğŸ•µğŸ¼
:spy_tone3	ğŸ•µğŸ½
:spy_tone4	ğŸ•µğŸ¾
:spy_tone5	ğŸ•µğŸ¿
:squeeze_bottle	ğŸ§´
:squid	ğŸ¦‘
:sr	ğŸ‡¸ğŸ‡·
:ss	ğŸ‡¸ğŸ‡¸
:st:	ğŸ‡¸ğŸ‡¹
:stadium	ğŸŸ
:star2	ğŸŒŸ
:star:	â­
:star_and_crescent	â˜ª
:star_of_david	âœ¡
:star_struck	ğŸ¤©
:stars	ğŸŒ 
:station	ğŸš‰
:statue_of_liberty	ğŸ—½
:steam_locomotive	ğŸš‚
:stew	ğŸ²
:stop_button	â¹
:stop_sign	ğŸ›‘
:stopwatch	â±
:straight_ruler	ğŸ“
:strawberry	ğŸ“
:stuck_out_tongue:	ğŸ˜›
:stuck_out_tongue_closed_eyes	ğŸ˜
:stuck_out_tongue_winking_eye	ğŸ˜œ
:studio_microphone	ğŸ™
:stuffed_flatbread	ğŸ¥™
:stuffed_pita	ğŸ¥™
:sun_with_face	ğŸŒ
:sunflower	ğŸŒ»
:sunglasses	ğŸ˜
:sunny	â˜€
:sunrise:	ğŸŒ…
:sunrise_over_mountains	ğŸŒ„
:superhero:	ğŸ¦¸
:superhero_dark_skin_tone	ğŸ¦¸ğŸ¿
:superhero_light_skin_tone	ğŸ¦¸ğŸ»
:superhero_medium_dark_skin_tone	ğŸ¦¸ğŸ¾
:superhero_medium_light_skin_tone	ğŸ¦¸ğŸ¼
:superhero_medium_skin_tone	ğŸ¦¸ğŸ½
:superhero_tone1	ğŸ¦¸ğŸ»
:superhero_tone2	ğŸ¦¸ğŸ¼
:superhero_tone3	ğŸ¦¸ğŸ½
:superhero_tone4	ğŸ¦¸ğŸ¾
:superhero_tone5	ğŸ¦¸ğŸ¿
:supervillain:	ğŸ¦¹
:supervillain_dark_skin_tone	ğŸ¦¹ğŸ¿
:supervillain_light_skin_tone	ğŸ¦¹ğŸ»
:supervillain_medium_dark_skin_tone	ğŸ¦¹ğŸ¾
:supervillain_medium_light_skin_tone	ğŸ¦¹ğŸ¼
:supervillain_medium_skin_tone	ğŸ¦¹ğŸ½
:supervillain_tone1	ğŸ¦¹ğŸ»
:supervillain_tone2	ğŸ¦¹ğŸ¼
:supervillain_tone3	ğŸ¦¹ğŸ½
:supervillain_tone4	ğŸ¦¹ğŸ¾
:supervillain_tone5	ğŸ¦¹ğŸ¿
:surfer:	ğŸ„
:surfer_tone1	ğŸ„ğŸ»
:surfer_tone2	ğŸ„ğŸ¼
:surfer_tone3	ğŸ„ğŸ½
:surfer_tone4	ğŸ„ğŸ¾
:surfer_tone5	ğŸ„ğŸ¿
:sushi	ğŸ£
:suspension_railway	ğŸšŸ
:sv	ğŸ‡¸ğŸ‡»
:swan	ğŸ¦¢
:sweat:	ğŸ˜“
:sweat_drops	ğŸ’¦
:sweat_smile	ğŸ˜…
:sweet_potato	ğŸ 
:swimmer:	ğŸŠ
:swimmer_tone1	ğŸŠğŸ»
:swimmer_tone2	ğŸŠğŸ¼
:swimmer_tone3	ğŸŠğŸ½
:swimmer_tone4	ğŸŠğŸ¾
:swimmer_tone5	ğŸŠğŸ¿
:sx	ğŸ‡¸ğŸ‡½
:sy:	ğŸ‡¸ğŸ‡¾
:symbols	ğŸ”£
:synagogue	ğŸ•
:syringe	ğŸ’‰
:sz	ğŸ‡¸ğŸ‡¿
:t_rex	ğŸ¦–
:ta:	ğŸ‡¹ğŸ‡¦
:table_tennis	ğŸ“
:taco	ğŸŒ®
:tada	ğŸ‰
:takeout_box	ğŸ¥¡
:tanabata_tree	ğŸ‹
:tangerine	ğŸŠ
:taurus	â™‰
:taxi	ğŸš•
:tc	ğŸ‡¹ğŸ‡¨
:td	ğŸ‡¹ğŸ‡©
:tea	ğŸµ
:teddy_bear	ğŸ§¸
:telephone:	â˜
:telephone_receiver	ğŸ“
:telescope	ğŸ”­
:tennis	ğŸ¾
:tent	â›º
:test_tube	ğŸ§ª
:tf	ğŸ‡¹ğŸ‡«
:tg	ğŸ‡¹ğŸ‡¬
:th:	ğŸ‡¹ğŸ‡­
:thermometer:	ğŸŒ¡
:thermometer_face	ğŸ¤’
:thinking	ğŸ¤”
:third_place	ğŸ¥‰
:thought_balloon	ğŸ’­
:thread	ğŸ§µ
:three:	3ï¸âƒ£
:three_button_mouse	ğŸ–±
:thumbdown:	ğŸ‘
:thumbdown_tone1	ğŸ‘ğŸ»
:thumbdown_tone2	ğŸ‘ğŸ¼
:thumbdown_tone3	ğŸ‘ğŸ½
:thumbdown_tone4	ğŸ‘ğŸ¾
:thumbdown_tone5	ğŸ‘ğŸ¿
:thumbsdown:	ğŸ‘
:thumbsdown_tone1	ğŸ‘ğŸ»
:thumbsdown_tone2	ğŸ‘ğŸ¼
:thumbsdown_tone3	ğŸ‘ğŸ½
:thumbsdown_tone4	ğŸ‘ğŸ¾
:thumbsdown_tone5	ğŸ‘ğŸ¿
:thumbsup:	ğŸ‘
:thumbsup_tone1	ğŸ‘ğŸ»
:thumbsup_tone2	ğŸ‘ğŸ¼
:thumbsup_tone3	ğŸ‘ğŸ½
:thumbsup_tone4	ğŸ‘ğŸ¾
:thumbsup_tone5	ğŸ‘ğŸ¿
:thumbup:	ğŸ‘
:thumbup_tone1	ğŸ‘ğŸ»
:thumbup_tone2	ğŸ‘ğŸ¼
:thumbup_tone3	ğŸ‘ğŸ½
:thumbup_tone4	ğŸ‘ğŸ¾
:thumbup_tone5	ğŸ‘ğŸ¿
:thunder_cloud_and_rain	â›ˆ
:thunder_cloud_rain	â›ˆ
:ticket:	ğŸ«
:tickets	ğŸŸ
:tiger2	ğŸ…
:tiger:	ğŸ¯
:timer	â²
:tired_face	ğŸ˜«
:tj	ğŸ‡¹ğŸ‡¯
:tk	ğŸ‡¹ğŸ‡°
:tl	ğŸ‡¹ğŸ‡±
:tm	â„¢
:tn	ğŸ‡¹ğŸ‡³
:to:	ğŸ‡¹ğŸ‡´
:toilet	ğŸš½
:tokyo_tower	ğŸ—¼
:tomato	ğŸ…
:tone1	ğŸ»
:tone2	ğŸ¼
:tone3	ğŸ½
:tone4	ğŸ¾
:tone5	ğŸ¿
:tongue	ğŸ‘…
:toolbox	ğŸ§°
:tools	ğŸ› 
:tooth	ğŸ¦·
:top:	ğŸ”
:tophat	ğŸ©
:tr:	ğŸ‡¹ğŸ‡·
:track_next	â­
:track_previous	â®
:trackball	ğŸ–²
:tractor	ğŸšœ
:traffic_light	ğŸš¥
:train2	ğŸš†
:train:	ğŸš‹
:tram	ğŸšŠ
:triangular_flag_on_post	ğŸš©
:triangular_ruler	ğŸ“
:trident	ğŸ”±
:triumph	ğŸ˜¤
:trolleybus	ğŸš
:trophy	ğŸ†
:tropical_drink	ğŸ¹
:tropical_fish	ğŸ 
:truck	ğŸšš
:trumpet	ğŸº
:tt	ğŸ‡¹ğŸ‡¹
:tulip	ğŸŒ·
:tumbler_glass	ğŸ¥ƒ
:turkey	ğŸ¦ƒ
:turkmenistan	ğŸ‡¹ğŸ‡²
:turtle	ğŸ¢
:tuvalu	ğŸ‡¹ğŸ‡»
:tuxedo_tone1	ğŸ¤µğŸ»
:tuxedo_tone2	ğŸ¤µğŸ¼
:tuxedo_tone3	ğŸ¤µğŸ½
:tuxedo_tone4	ğŸ¤µğŸ¾
:tuxedo_tone5	ğŸ¤µğŸ¿
:tv	ğŸ“º
:tw:	ğŸ‡¹ğŸ‡¼
:twisted_rightwards_arrows	ğŸ”€
:two:	2ï¸âƒ£
:two_hearts	ğŸ’•
:two_men_holding_hands	ğŸ‘¬
:two_women_holding_hands	ğŸ‘­
:tz	ğŸ‡¹ğŸ‡¿
:u5272	ğŸˆ¹
:u5408	ğŸˆ´
:u55b6	ğŸˆº
:u6307	ğŸˆ¯
:u6708	ğŸˆ·
:u6709	ğŸˆ¶
:u6e80	ğŸˆµ
:u7121	ğŸˆš
:u7533	ğŸˆ¸
:u7981	ğŸˆ²
:u7a7a	ğŸˆ³
:ua	ğŸ‡ºğŸ‡¦
:ug	ğŸ‡ºğŸ‡¬
:um:	ğŸ‡ºğŸ‡²
:umbrella2	â˜‚
:umbrella:	â˜”
:umbrella_on_ground	â›±
:unamused	ğŸ˜’
:underage	ğŸ”
:unicorn	ğŸ¦„
:united_nations	ğŸ‡ºğŸ‡³
:unlock	ğŸ”“
:up:	ğŸ†™
:upside_down	ğŸ™ƒ
:urn	âš±
:us	ğŸ‡ºğŸ‡¸
:uy	ğŸ‡ºğŸ‡¾
:uz	ğŸ‡ºğŸ‡¿
:v:	âœŒ
:v_tone1	âœŒğŸ»
:v_tone2	âœŒğŸ¼
:v_tone3	âœŒğŸ½
:v_tone4	âœŒğŸ¾
:v_tone5	âœŒğŸ¿
:va:	ğŸ‡»ğŸ‡¦
:vampire:	ğŸ§›
:vampire_dark_skin_tone	ğŸ§›ğŸ¿
:vampire_light_skin_tone	ğŸ§›ğŸ»
:vampire_medium_dark_skin_tone	ğŸ§›ğŸ¾
:vampire_medium_light_skin_tone	ğŸ§›ğŸ¼
:vampire_medium_skin_tone	ğŸ§›ğŸ½
:vampire_tone1	ğŸ§›ğŸ»
:vampire_tone2	ğŸ§›ğŸ¼
:vampire_tone3	ğŸ§›ğŸ½
:vampire_tone4	ğŸ§›ğŸ¾
:vampire_tone5	ğŸ§›ğŸ¿
:vc	ğŸ‡»ğŸ‡¨
:ve:	ğŸ‡»ğŸ‡ª
:vertical_traffic_light	ğŸš¦
:vg	ğŸ‡»ğŸ‡¬
:vhs	ğŸ“¼
:vi:	ğŸ‡»ğŸ‡®
:vibration_mode	ğŸ“³
:video_camera	ğŸ“¹
:video_game	ğŸ®
:violin	ğŸ»
:virgo	â™
:vn	ğŸ‡»ğŸ‡³
:volcano	ğŸŒ‹
:volleyball	ğŸ
:vs	ğŸ†š
:vu:	ğŸ‡»ğŸ‡º
:vulcan:	ğŸ––
:vulcan_tone1	ğŸ––ğŸ»
:vulcan_tone2	ğŸ––ğŸ¼
:vulcan_tone3	ğŸ––ğŸ½
:vulcan_tone4	ğŸ––ğŸ¾
:vulcan_tone5	ğŸ––ğŸ¿
:walking:	ğŸš¶
:walking_tone1	ğŸš¶ğŸ»
:walking_tone2	ğŸš¶ğŸ¼
:walking_tone3	ğŸš¶ğŸ½
:walking_tone4	ğŸš¶ğŸ¾
:walking_tone5	ğŸš¶ğŸ¿
:waning_crescent_moon	ğŸŒ˜
:waning_gibbous_moon	ğŸŒ–
:warning	âš 
:wastebasket	ğŸ—‘
:watch	âŒš
:water_buffalo	ğŸƒ
:water_polo:	ğŸ¤½
:water_polo_tone1	ğŸ¤½ğŸ»
:water_polo_tone2	ğŸ¤½ğŸ¼
:water_polo_tone3	ğŸ¤½ğŸ½
:water_polo_tone4	ğŸ¤½ğŸ¾
:water_polo_tone5	ğŸ¤½ğŸ¿
:watermelon	ğŸ‰
:wave:	ğŸ‘‹
:wave_tone1	ğŸ‘‹ğŸ»
:wave_tone2	ğŸ‘‹ğŸ¼
:wave_tone3	ğŸ‘‹ğŸ½
:wave_tone4	ğŸ‘‹ğŸ¾
:wave_tone5	ğŸ‘‹ğŸ¿
:waving_black_flag	ğŸ´
:waving_white_flag	ğŸ³
:wavy_dash	ã€°
:waxing_crescent_moon	ğŸŒ’
:waxing_gibbous_moon	ğŸŒ”
:wc	ğŸš¾
:weary	ğŸ˜©
:wedding	ğŸ’’
:weight_lifter:	ğŸ‹
:weight_lifter_tone1	ğŸ‹ğŸ»
:weight_lifter_tone2	ğŸ‹ğŸ¼
:weight_lifter_tone3	ğŸ‹ğŸ½
:weight_lifter_tone4	ğŸ‹ğŸ¾
:weight_lifter_tone5	ğŸ‹ğŸ¿
:wf	ğŸ‡¼ğŸ‡«
:whale2	ğŸ‹
:whale:	ğŸ³
:wheel_of_dharma	â˜¸
:wheelchair	â™¿
:whisky	ğŸ¥ƒ
:white_check_mark	âœ…
:white_circle	âšª
:white_flower	ğŸ’®
:white_frowning_face	â˜¹
:white_haired	ğŸ¦³
:white_large_square	â¬œ
:white_medium_small_square	â—½
:white_medium_square	â—»
:white_small_square	â–«
:white_square_button	ğŸ”³
:white_sun_behind_cloud:	ğŸŒ¥
:white_sun_behind_cloud_with_rain	ğŸŒ¦
:white_sun_cloud	ğŸŒ¥
:white_sun_rain_cloud	ğŸŒ¦
:white_sun_small_cloud	ğŸŒ¤
:white_sun_with_small_cloud	ğŸŒ¤
:wilted_flower	ğŸ¥€
:wilted_rose	ğŸ¥€
:wind_blowing_face	ğŸŒ¬
:wind_chime	ğŸ
:wine_glass	ğŸ·
:wink	ğŸ˜‰
:wolf	ğŸº
:woman:	ğŸ‘©
:woman_artist:	ğŸ‘©â€ğŸ¨
:woman_artist_dark_skin_tone	ğŸ‘©ğŸ¿â€ğŸ¨
:woman_artist_light_skin_tone	ğŸ‘©ğŸ»â€ğŸ¨
:woman_artist_medium_dark_skin_tone	ğŸ‘©ğŸ¾â€ğŸ¨
:woman_artist_medium_light_skin_tone	ğŸ‘©ğŸ¼â€ğŸ¨
:woman_artist_medium_skin_tone	ğŸ‘©ğŸ½â€ğŸ¨
:woman_artist_tone1	ğŸ‘©ğŸ»â€ğŸ¨
:woman_artist_tone2	ğŸ‘©ğŸ¼â€ğŸ¨
:woman_artist_tone3	ğŸ‘©ğŸ½â€ğŸ¨
:woman_artist_tone4	ğŸ‘©ğŸ¾â€ğŸ¨
:woman_artist_tone5	ğŸ‘©ğŸ¿â€ğŸ¨
:woman_astronaut:	ğŸ‘©â€ğŸš€
:woman_astronaut_dark_skin_tone	ğŸ‘©ğŸ¿â€ğŸš€
:woman_astronaut_light_skin_tone	ğŸ‘©ğŸ»â€ğŸš€
:woman_astronaut_medium_dark_skin_tone	ğŸ‘©ğŸ¾â€ğŸš€
:woman_astronaut_medium_light_skin_tone	ğŸ‘©ğŸ¼â€ğŸš€
:woman_astronaut_medium_skin_tone	ğŸ‘©ğŸ½â€ğŸš€
:woman_astronaut_tone1	ğŸ‘©ğŸ»â€ğŸš€
:woman_astronaut_tone2	ğŸ‘©ğŸ¼â€ğŸš€
:woman_astronaut_tone3	ğŸ‘©ğŸ½â€ğŸš€
:woman_astronaut_tone4	ğŸ‘©ğŸ¾â€ğŸš€
:woman_astronaut_tone5	ğŸ‘©ğŸ¿â€ğŸš€
:woman_bald:	ğŸ‘©â€ğŸ¦²
:woman_bald_dark_skin_tone	ğŸ‘©ğŸ¿â€ğŸ¦²
:woman_bald_light_skin_tone	ğŸ‘©ğŸ»â€ğŸ¦²
:woman_bald_medium_dark_skin_tone	ğŸ‘©ğŸ¾â€ğŸ¦²
:woman_bald_medium_light_skin_tone	ğŸ‘©ğŸ¼â€ğŸ¦²
:woman_bald_medium_skin_tone	ğŸ‘©ğŸ½â€ğŸ¦²
:woman_bald_tone1	ğŸ‘©ğŸ»â€ğŸ¦²
:woman_bald_tone2	ğŸ‘©ğŸ¼â€ğŸ¦²
:woman_bald_tone3	ğŸ‘©ğŸ½â€ğŸ¦²
:woman_bald_tone4	ğŸ‘©ğŸ¾â€ğŸ¦²
:woman_bald_tone5	ğŸ‘©ğŸ¿â€ğŸ¦²
:woman_biking	ğŸš´â€â™€ï¸
:woman_bowing	ğŸ™‡â€â™€ï¸
:woman_cartwheeling	ğŸ¤¸â€â™€ï¸
:woman_climbing	ğŸ§—â€â™€ï¸
:woman_construction_worker	ğŸ‘·â€â™€ï¸
:woman_cook:	ğŸ‘©â€ğŸ³
:woman_cook_dark_skin_tone	ğŸ‘©ğŸ¿â€ğŸ³
:woman_cook_light_skin_tone	ğŸ‘©ğŸ»â€ğŸ³
:woman_cook_medium_dark_skin_tone	ğŸ‘©ğŸ¾â€ğŸ³
:woman_cook_medium_light_skin_tone	ğŸ‘©ğŸ¼â€ğŸ³
:woman_cook_medium_skin_tone	ğŸ‘©ğŸ½â€ğŸ³
:woman_cook_tone1	ğŸ‘©ğŸ»â€ğŸ³
:woman_cook_tone2	ğŸ‘©ğŸ¼â€ğŸ³
:woman_cook_tone3	ğŸ‘©ğŸ½â€ğŸ³
:woman_cook_tone4	ğŸ‘©ğŸ¾â€ğŸ³
:woman_cook_tone5	ğŸ‘©ğŸ¿â€ğŸ³
:woman_curly_haired:	ğŸ‘©â€ğŸ¦±
:woman_curly_haired_dark_skin_tone	ğŸ‘©ğŸ¿â€ğŸ¦±
:woman_curly_haired_light_skin_tone	ğŸ‘©ğŸ»â€ğŸ¦±
:woman_curly_haired_medium_dark_skin_tone	ğŸ‘©ğŸ¾â€ğŸ¦±
:woman_curly_haired_medium_light_skin_tone	ğŸ‘©ğŸ¼â€ğŸ¦±
:woman_curly_haired_medium_skin_tone	ğŸ‘©ğŸ½â€ğŸ¦±
:woman_curly_haired_tone1	ğŸ‘©ğŸ»â€ğŸ¦±
:woman_curly_haired_tone2	ğŸ‘©ğŸ¼â€ğŸ¦±
:woman_curly_haired_tone3	ğŸ‘©ğŸ½â€ğŸ¦±
:woman_curly_haired_tone4	ğŸ‘©ğŸ¾â€ğŸ¦±
:woman_curly_haired_tone5	ğŸ‘©ğŸ¿â€ğŸ¦±
:woman_elf	ğŸ§â€â™€ï¸
:woman_facepalming	ğŸ¤¦â€â™€ï¸
:woman_factory_worker:	ğŸ‘©â€ğŸ­
:woman_factory_worker_dark_skin_tone	ğŸ‘©ğŸ¿â€ğŸ­
:woman_factory_worker_light_skin_tone	ğŸ‘©ğŸ»â€ğŸ­
:woman_factory_worker_medium_dark_skin_tone	ğŸ‘©ğŸ¾â€ğŸ­
:woman_factory_worker_medium_light_skin_tone	ğŸ‘©ğŸ¼â€ğŸ­
:woman_factory_worker_medium_skin_tone	ğŸ‘©ğŸ½â€ğŸ­
:woman_factory_worker_tone1	ğŸ‘©ğŸ»â€ğŸ­
:woman_factory_worker_tone2	ğŸ‘©ğŸ¼â€ğŸ­
:woman_factory_worker_tone3	ğŸ‘©ğŸ½â€ğŸ­
:woman_factory_worker_tone4	ğŸ‘©ğŸ¾â€ğŸ­
:woman_factory_worker_tone5	ğŸ‘©ğŸ¿â€ğŸ­
:woman_fairy	ğŸ§šâ€â™€ï¸
:woman_farmer:	ğŸ‘©â€ğŸŒ¾
:woman_farmer_dark_skin_tone	ğŸ‘©ğŸ¿â€ğŸŒ¾
:woman_farmer_light_skin_tone	ğŸ‘©ğŸ»â€ğŸŒ¾
:woman_farmer_medium_dark_skin_tone	ğŸ‘©ğŸ¾â€ğŸŒ¾
:woman_farmer_medium_light_skin_tone	ğŸ‘©ğŸ¼â€ğŸŒ¾
:woman_farmer_medium_skin_tone	ğŸ‘©ğŸ½â€ğŸŒ¾
:woman_farmer_tone1	ğŸ‘©ğŸ»â€ğŸŒ¾
:woman_farmer_tone2	ğŸ‘©ğŸ¼â€ğŸŒ¾
:woman_farmer_tone3	ğŸ‘©ğŸ½â€ğŸŒ¾
:woman_farmer_tone4	ğŸ‘©ğŸ¾â€ğŸŒ¾
:woman_farmer_tone5	ğŸ‘©ğŸ¿â€ğŸŒ¾
:woman_firefighter:	ğŸ‘©â€ğŸš’
:woman_firefighter_dark_skin_tone	ğŸ‘©ğŸ¿â€ğŸš’
:woman_firefighter_light_skin_tone	ğŸ‘©ğŸ»â€ğŸš’
:woman_firefighter_medium_dark_skin_tone	ğŸ‘©ğŸ¾â€ğŸš’
:woman_firefighter_medium_light_skin_tone	ğŸ‘©ğŸ¼â€ğŸš’
:woman_firefighter_medium_skin_tone	ğŸ‘©ğŸ½â€ğŸš’
:woman_firefighter_tone1	ğŸ‘©ğŸ»â€ğŸš’
:woman_firefighter_tone2	ğŸ‘©ğŸ¼â€ğŸš’
:woman_firefighter_tone3	ğŸ‘©ğŸ½â€ğŸš’
:woman_firefighter_tone4	ğŸ‘©ğŸ¾â€ğŸš’
:woman_firefighter_tone5	ğŸ‘©ğŸ¿â€ğŸš’
:woman_frowning	ğŸ™â€â™€ï¸
:woman_genie	ğŸ§â€â™€ï¸
:woman_gesturing_no	ğŸ™…â€â™€ï¸
:woman_gesturing_ok	ğŸ™†â€â™€ï¸
:woman_getting_face_massage	ğŸ’†â€â™€ï¸
:woman_getting_haircut	ğŸ’‡â€â™€ï¸
:woman_guard	ğŸ’‚â€â™€ï¸
:woman_health_worker	ğŸ‘©â€âš•ï¸
:woman_in_lotus_position	ğŸ§˜â€â™€ï¸
:woman_in_steamy_room	ğŸ§–â€â™€ï¸
:woman_judge	ğŸ‘©â€âš–ï¸
:woman_juggling	ğŸ¤¹â€â™€ï¸
:woman_mage	ğŸ§™â€â™€ï¸
:woman_mechanic:	ğŸ‘©â€ğŸ”§
:woman_mechanic_dark_skin_tone	ğŸ‘©ğŸ¿â€ğŸ”§
:woman_mechanic_light_skin_tone	ğŸ‘©ğŸ»â€ğŸ”§
:woman_mechanic_medium_dark_skin_tone	ğŸ‘©ğŸ¾â€ğŸ”§
:woman_mechanic_medium_light_skin_tone	ğŸ‘©ğŸ¼â€ğŸ”§
:woman_mechanic_medium_skin_tone	ğŸ‘©ğŸ½â€ğŸ”§
:woman_mechanic_tone1	ğŸ‘©ğŸ»â€ğŸ”§
:woman_mechanic_tone2	ğŸ‘©ğŸ¼â€ğŸ”§
:woman_mechanic_tone3	ğŸ‘©ğŸ½â€ğŸ”§
:woman_mechanic_tone4	ğŸ‘©ğŸ¾â€ğŸ”§
:woman_mechanic_tone5	ğŸ‘©ğŸ¿â€ğŸ”§
:woman_mountain_biking	ğŸšµâ€â™€ï¸
:woman_office_worker:	ğŸ‘©â€ğŸ’¼
:woman_office_worker_dark_skin_tone	ğŸ‘©ğŸ¿â€ğŸ’¼
:woman_office_worker_light_skin_tone	ğŸ‘©ğŸ»â€ğŸ’¼
:woman_office_worker_medium_dark_skin_tone	ğŸ‘©ğŸ¾â€ğŸ’¼
:woman_office_worker_medium_light_skin_tone	ğŸ‘©ğŸ¼â€ğŸ’¼
:woman_office_worker_medium_skin_tone	ğŸ‘©ğŸ½â€ğŸ’¼
:woman_office_worker_tone1	ğŸ‘©ğŸ»â€ğŸ’¼
:woman_office_worker_tone2	ğŸ‘©ğŸ¼â€ğŸ’¼
:woman_office_worker_tone3	ğŸ‘©ğŸ½â€ğŸ’¼
:woman_office_worker_tone4	ğŸ‘©ğŸ¾â€ğŸ’¼
:woman_office_worker_tone5	ğŸ‘©ğŸ¿â€ğŸ’¼
:woman_pilot	ğŸ‘©â€âœˆï¸
:woman_playing_handball	ğŸ¤¾â€â™€ï¸
:woman_playing_water_polo	ğŸ¤½â€â™€ï¸
:woman_police_officer	ğŸ‘®â€â™€ï¸
:woman_pouting	ğŸ™â€â™€ï¸
:woman_raising_hand	ğŸ™‹â€â™€ï¸
:woman_red_haired:	ğŸ‘©â€ğŸ¦°
:woman_red_haired_dark_skin_tone	ğŸ‘©ğŸ¿â€ğŸ¦°
:woman_red_haired_light_skin_tone	ğŸ‘©ğŸ»â€ğŸ¦°
:woman_red_haired_medium_dark_skin_tone	ğŸ‘©ğŸ¾â€ğŸ¦°
:woman_red_haired_medium_light_skin_tone	ğŸ‘©ğŸ¼â€ğŸ¦°
:woman_red_haired_medium_skin_tone	ğŸ‘©ğŸ½â€ğŸ¦°
:woman_red_haired_tone1	ğŸ‘©ğŸ»â€ğŸ¦°
:woman_red_haired_tone2	ğŸ‘©ğŸ¼â€ğŸ¦°
:woman_red_haired_tone3	ğŸ‘©ğŸ½â€ğŸ¦°
:woman_red_haired_tone4	ğŸ‘©ğŸ¾â€ğŸ¦°
:woman_red_haired_tone5	ğŸ‘©ğŸ¿â€ğŸ¦°
:woman_rowing_boat	ğŸš£â€â™€ï¸
:woman_running	ğŸƒâ€â™€ï¸
:woman_scientist:	ğŸ‘©â€ğŸ”¬
:woman_scientist_dark_skin_tone	ğŸ‘©ğŸ¿â€ğŸ”¬
:woman_scientist_light_skin_tone	ğŸ‘©ğŸ»â€ğŸ”¬
:woman_scientist_medium_dark_skin_tone	ğŸ‘©ğŸ¾â€ğŸ”¬
:woman_scientist_medium_light_skin_tone	ğŸ‘©ğŸ¼â€ğŸ”¬
:woman_scientist_medium_skin_tone	ğŸ‘©ğŸ½â€ğŸ”¬
:woman_scientist_tone1	ğŸ‘©ğŸ»â€ğŸ”¬
:woman_scientist_tone2	ğŸ‘©ğŸ¼â€ğŸ”¬
:woman_scientist_tone3	ğŸ‘©ğŸ½â€ğŸ”¬
:woman_scientist_tone4	ğŸ‘©ğŸ¾â€ğŸ”¬
:woman_scientist_tone5	ğŸ‘©ğŸ¿â€ğŸ”¬
:woman_shrugging	ğŸ¤·â€â™€ï¸
:woman_singer:	ğŸ‘©â€ğŸ¤
:woman_singer_dark_skin_tone	ğŸ‘©ğŸ¿â€ğŸ¤
:woman_singer_light_skin_tone	ğŸ‘©ğŸ»â€ğŸ¤
:woman_singer_medium_dark_skin_tone	ğŸ‘©ğŸ¾â€ğŸ¤
:woman_singer_medium_light_skin_tone	ğŸ‘©ğŸ¼â€ğŸ¤
:woman_singer_medium_skin_tone	ğŸ‘©ğŸ½â€ğŸ¤
:woman_singer_tone1	ğŸ‘©ğŸ»â€ğŸ¤
:woman_singer_tone2	ğŸ‘©ğŸ¼â€ğŸ¤
:woman_singer_tone3	ğŸ‘©ğŸ½â€ğŸ¤
:woman_singer_tone4	ğŸ‘©ğŸ¾â€ğŸ¤
:woman_singer_tone5	ğŸ‘©ğŸ¿â€ğŸ¤
:woman_student:	ğŸ‘©â€ğŸ“
:woman_student_dark_skin_tone	ğŸ‘©ğŸ¿â€ğŸ“
:woman_student_light_skin_tone	ğŸ‘©ğŸ»â€ğŸ“
:woman_student_medium_dark_skin_tone	ğŸ‘©ğŸ¾â€ğŸ“
:woman_student_medium_light_skin_tone	ğŸ‘©ğŸ¼â€ğŸ“
:woman_student_medium_skin_tone	ğŸ‘©ğŸ½â€ğŸ“
:woman_student_tone1	ğŸ‘©ğŸ»â€ğŸ“
:woman_student_tone2	ğŸ‘©ğŸ¼â€ğŸ“
:woman_student_tone3	ğŸ‘©ğŸ½â€ğŸ“
:woman_student_tone4	ğŸ‘©ğŸ¾â€ğŸ“
:woman_student_tone5	ğŸ‘©ğŸ¿â€ğŸ“
:woman_superhero	ğŸ¦¸â€â™€ï¸
:woman_supervillain	ğŸ¦¹â€â™€ï¸
:woman_surfing	ğŸ„â€â™€ï¸
:woman_swimming	ğŸŠâ€â™€ï¸
:woman_teacher:	ğŸ‘©â€ğŸ«
:woman_teacher_dark_skin_tone	ğŸ‘©ğŸ¿â€ğŸ«
:woman_teacher_light_skin_tone	ğŸ‘©ğŸ»â€ğŸ«
:woman_teacher_medium_dark_skin_tone	ğŸ‘©ğŸ¾â€ğŸ«
:woman_teacher_medium_light_skin_tone	ğŸ‘©ğŸ¼â€ğŸ«
:woman_teacher_medium_skin_tone	ğŸ‘©ğŸ½â€ğŸ«
:woman_teacher_tone1	ğŸ‘©ğŸ»â€ğŸ«
:woman_teacher_tone2	ğŸ‘©ğŸ¼â€ğŸ«
:woman_teacher_tone3	ğŸ‘©ğŸ½â€ğŸ«
:woman_teacher_tone4	ğŸ‘©ğŸ¾â€ğŸ«
:woman_teacher_tone5	ğŸ‘©ğŸ¿â€ğŸ«
:woman_technologist:	ğŸ‘©â€ğŸ’»
:woman_technologist_dark_skin_tone	ğŸ‘©ğŸ¿â€ğŸ’»
:woman_technologist_light_skin_tone	ğŸ‘©ğŸ»â€ğŸ’»
:woman_technologist_medium_dark_skin_tone	ğŸ‘©ğŸ¾â€ğŸ’»
:woman_technologist_medium_light_skin_tone	ğŸ‘©ğŸ¼â€ğŸ’»
:woman_technologist_medium_skin_tone	ğŸ‘©ğŸ½â€ğŸ’»
:woman_technologist_tone1	ğŸ‘©ğŸ»â€ğŸ’»
:woman_technologist_tone2	ğŸ‘©ğŸ¼â€ğŸ’»
:woman_technologist_tone3	ğŸ‘©ğŸ½â€ğŸ’»
:woman_technologist_tone4	ğŸ‘©ğŸ¾â€ğŸ’»
:woman_technologist_tone5	ğŸ‘©ğŸ¿â€ğŸ’»
:woman_tipping_hand	ğŸ’â€â™€ï¸
:woman_tone1	ğŸ‘©ğŸ»
:woman_tone2	ğŸ‘©ğŸ¼
:woman_tone3	ğŸ‘©ğŸ½
:woman_tone4	ğŸ‘©ğŸ¾
:woman_tone5	ğŸ‘©ğŸ¿
:woman_vampire	ğŸ§›â€â™€ï¸
:woman_walking	ğŸš¶â€â™€ï¸
:woman_wearing_turban	ğŸ‘³â€â™€ï¸
:woman_white_haired:	ğŸ‘©â€ğŸ¦³
:woman_white_haired_dark_skin_tone	ğŸ‘©ğŸ¿â€ğŸ¦³
:woman_white_haired_light_skin_tone	ğŸ‘©ğŸ»â€ğŸ¦³
:woman_white_haired_medium_dark_skin_tone	ğŸ‘©ğŸ¾â€ğŸ¦³
:woman_white_haired_medium_light_skin_tone	ğŸ‘©ğŸ¼â€ğŸ¦³
:woman_white_haired_medium_skin_tone	ğŸ‘©ğŸ½â€ğŸ¦³
:woman_white_haired_tone1	ğŸ‘©ğŸ»â€ğŸ¦³
:woman_white_haired_tone2	ğŸ‘©ğŸ¼â€ğŸ¦³
:woman_white_haired_tone3	ğŸ‘©ğŸ½â€ğŸ¦³
:woman_white_haired_tone4	ğŸ‘©ğŸ¾â€ğŸ¦³
:woman_white_haired_tone5	ğŸ‘©ğŸ¿â€ğŸ¦³
:woman_with_headscarf:	ğŸ§•
:woman_with_headscarf_dark_skin_tone	ğŸ§•ğŸ¿
:woman_with_headscarf_light_skin_tone	ğŸ§•ğŸ»
:woman_with_headscarf_medium_dark_skin_tone	ğŸ§•ğŸ¾
:woman_with_headscarf_medium_light_skin_tone	ğŸ§•ğŸ¼
:woman_with_headscarf_medium_skin_tone	ğŸ§•ğŸ½
:woman_with_headscarf_tone1	ğŸ§•ğŸ»
:woman_with_headscarf_tone2	ğŸ§•ğŸ¼
:woman_with_headscarf_tone3	ğŸ§•ğŸ½
:woman_with_headscarf_tone4	ğŸ§•ğŸ¾
:woman_with_headscarf_tone5	ğŸ§•ğŸ¿
:woman_zombie	ğŸ§Ÿâ€â™€ï¸
:womans_clothes	ğŸ‘š
:womans_flat_shoe	ğŸ¥¿
:womans_hat	ğŸ‘’
:women_with_bunny_ears_partying	ğŸ‘¯â€â™€ï¸
:women_wrestling	ğŸ¤¼â€â™€ï¸
:womens	ğŸšº
:woozy_face	ğŸ¥´
:world_map	ğŸ—º
:worried	ğŸ˜Ÿ
:worship_symbol	ğŸ›
:wrench	ğŸ”§
:wrestlers	ğŸ¤¼
:wrestling	ğŸ¤¼
:writing_hand:	âœ
:writing_hand_tone1	âœğŸ»
:writing_hand_tone2	âœğŸ¼
:writing_hand_tone3	âœğŸ½
:writing_hand_tone4	âœğŸ¾
:writing_hand_tone5	âœğŸ¿
:ws	ğŸ‡¼ğŸ‡¸
:x:	âŒ
:xk	ğŸ‡½ğŸ‡°
:yarn	ğŸ§¶
:ye:	ğŸ‡¾ğŸ‡ª
:yellow_heart	ğŸ’›
:yen	ğŸ’´
:yin_yang	â˜¯
:yt	ğŸ‡¾ğŸ‡¹
:yum	ğŸ˜‹
:za:	ğŸ‡¿ğŸ‡¦
:zany_face	ğŸ¤ª
:zap	âš¡
:zebra	ğŸ¦“
:zero	0ï¸âƒ£
:zipper_mouth	ğŸ¤
:zm	ğŸ‡¿ğŸ‡²
:zombie	ğŸ§Ÿ
:zw	ğŸ‡¿ğŸ‡¼
:zzz	ğŸ’¤
