:grinning:	ğŸ˜€
:smiley:	ğŸ˜ƒ
:smile:	ğŸ˜„
:grin:	ğŸ˜
:laughing:	ğŸ˜†
:satisfied:	ğŸ˜†
:sweat_smile:	ğŸ˜…
:joy:	ğŸ˜‚
:rofl:	ğŸ¤£
:rolling_on_the_floor_laughing:	ğŸ¤£
:relaxed:	â˜º
:blush:	ğŸ˜Š
:innocent:	ğŸ˜‡
:slight_smile:	ğŸ™‚
:slightly_smiling_face:	ğŸ™‚
:upside_down:	ğŸ™ƒ
:upside_down_face:	ğŸ™ƒ
:wink:	ğŸ˜‰
:relieved:	ğŸ˜Œ
:heart_eyes:	ğŸ˜
:kissing_heart:	ğŸ˜˜
:kissing:	ğŸ˜—
:kissing_smiling_eyes:	ğŸ˜™
:kissing_closed_eyes:	ğŸ˜š
:yum:	ğŸ˜‹
:stuck_out_tongue_winking_eye:	ğŸ˜œ
:stuck_out_tongue_closed_eyes:	ğŸ˜
:stuck_out_tongue:	ğŸ˜›
:money_mouth:	ğŸ¤‘
:money_mouth_face:	ğŸ¤‘
:hugging:	ğŸ¤—
:hugging_face:	ğŸ¤—
:nerd:	ğŸ¤“
:nerd_face:	ğŸ¤“
:sunglasses:	ğŸ˜
:clown:	ğŸ¤¡
:clown_face:	ğŸ¤¡
:cowboy:	ğŸ¤ 
:face_with_cowboy_hat:	ğŸ¤ 
:smirk:	ğŸ˜
:unamused:	ğŸ˜’
:disappointed:	ğŸ˜
:pensive:	ğŸ˜”
:worried:	ğŸ˜Ÿ
:confused:	ğŸ˜•
:slight_frown:	ğŸ™
:slightly_frowning_face:	ğŸ™
:frowning2:	â˜¹
:white_frowning_face:	â˜¹
:persevere:	ğŸ˜£
:confounded:	ğŸ˜–
:tired_face:	ğŸ˜«
:weary:	ğŸ˜©
:triumph:	ğŸ˜¤
:angry:	ğŸ˜ 
:rage:	ğŸ˜¡
:no_mouth:	ğŸ˜¶
:neutral_face:	ğŸ˜
:expressionless:	ğŸ˜‘
:hushed:	ğŸ˜¯
:frowning:	ğŸ˜¦
:anguished:	ğŸ˜§
:open_mouth:	ğŸ˜®
:astonished:	ğŸ˜²
:dizzy_face:	ğŸ˜µ
:flushed:	ğŸ˜³
:scream:	ğŸ˜±
:fearful:	ğŸ˜¨
:cold_sweat:	ğŸ˜°
:cry:	ğŸ˜¢
:disappointed_relieved:	ğŸ˜¥
:drooling_face:	ğŸ¤¤
:drool:	ğŸ¤¤
:sob:	ğŸ˜­
:sweat:	ğŸ˜“
:sleepy:	ğŸ˜ª
:sleeping:	ğŸ˜´
:rolling_eyes:	ğŸ™„
:face_with_rolling_eyes:	ğŸ™„
:thinking:	ğŸ¤”
:thinking_face:	ğŸ¤”
:lying_face:	ğŸ¤¥
:liar:	ğŸ¤¥
:grimacing:	ğŸ˜¬
:zipper_mouth:	ğŸ¤
:zipper_mouth_face:	ğŸ¤
:nauseated_face:	ğŸ¤¢
:sick:	ğŸ¤¢
:sneezing_face:	ğŸ¤§
:sneeze:	ğŸ¤§
:mask:	ğŸ˜·
:thermometer_face:	ğŸ¤’
:face_with_thermometer:	ğŸ¤’
:head_bandage:	ğŸ¤•
:face_with_head_bandage:	ğŸ¤•
:smiling_imp:	ğŸ˜ˆ
:imp:	ğŸ‘¿
:japanese_ogre:	ğŸ‘¹
:japanese_goblin:	ğŸ‘º
:poop:	ğŸ’©
:shit:	ğŸ’©
:hankey:	ğŸ’©
:poo:	ğŸ’©
:ghost:	ğŸ‘»
:skull:	ğŸ’€
:skeleton:	ğŸ’€
:skull_crossbones:	â˜ 
:skull_and_crossbones:	â˜ 
:alien:	ğŸ‘½
:space_invader:	ğŸ‘¾
:robot:	ğŸ¤–
:robot_face:	ğŸ¤–
:jack_o_lantern:	ğŸƒ
:smiley_cat:	ğŸ˜º
:smile_cat:	ğŸ˜¸
:joy_cat:	ğŸ˜¹
:heart_eyes_cat:	ğŸ˜»
:smirk_cat:	ğŸ˜¼
:kissing_cat:	ğŸ˜½
:scream_cat:	ğŸ™€
:crying_cat_face:	ğŸ˜¿
:pouting_cat:	ğŸ˜¾
:open_hands:	ğŸ‘
:raised_hands:	ğŸ™Œ
:clap:	ğŸ‘
:pray:	ğŸ™
:handshake:	ğŸ¤
:shaking_hands:	ğŸ¤
:thumbsup:	ğŸ‘
:+1:	ğŸ‘
:thumbup:	ğŸ‘
:thumbsdown:	ğŸ‘
:-1:	ğŸ‘
:thumbdown:	ğŸ‘
:punch:	ğŸ‘Š
:fist:	âœŠ
:left_facing_fist:	ğŸ¤›
:left_fist:	ğŸ¤›
:right_facing_fist:	ğŸ¤œ
:right_fist:	ğŸ¤œ
:fingers_crossed:	ğŸ¤
:hand_with_index_and_middle_finger_crossed:	ğŸ¤
:v:	âœŒ
:metal:	ğŸ¤˜
:sign_of_the_horns:	ğŸ¤˜
:ok_hand:	ğŸ‘Œ
:point_left:	ğŸ‘ˆ
:point_right:	ğŸ‘‰
:point_up_2:	ğŸ‘†
:point_down:	ğŸ‘‡
:point_up:	â˜
:raised_hand:	âœ‹
:raised_back_of_hand:	ğŸ¤š
:back_of_hand:	ğŸ¤š
:hand_splayed:	ğŸ–
:raised_hand_with_fingers_splayed:	ğŸ–
:vulcan:	ğŸ––
:raised_hand_with_part_between_middle_and_ring_fingers:	ğŸ––
:wave:	ğŸ‘‹
:call_me:	ğŸ¤™
:call_me_hand:	ğŸ¤™
:muscle:	ğŸ’ª
:middle_finger:	ğŸ–•
:reversed_hand_with_middle_finger_extended:	ğŸ–•
:writing_hand:	âœ
:selfie:	ğŸ¤³
:nail_care:	ğŸ’…
:ring:	ğŸ’
:lipstick:	ğŸ’„
:kiss:	ğŸ’‹
:lips:	ğŸ‘„
:tongue:	ğŸ‘…
:ear:	ğŸ‘‚
:nose:	ğŸ‘ƒ
:footprints:	ğŸ‘£
:eye:	ğŸ‘
:eyes:	ğŸ‘€
:speaking_head:	ğŸ—£
:speaking_head_in_silhouette:	ğŸ—£
:bust_in_silhouette:	ğŸ‘¤
:busts_in_silhouette:	ğŸ‘¥
:baby:	ğŸ‘¶
:boy:	ğŸ‘¦
:girl:	ğŸ‘§
:man:	ğŸ‘¨
:woman:	ğŸ‘©
:blond_haired_person:	ğŸ‘±
:person_with_blond_hair:	ğŸ‘±
:older_man:	ğŸ‘´
:older_woman:	ğŸ‘µ
:grandma:	ğŸ‘µ
:man_with_chinese_cap:	ğŸ‘²
:man_with_gua_pi_mao:	ğŸ‘²
:person_wearing_turban:	ğŸ‘³
:man_with_turban:	ğŸ‘³
:police_officer:	ğŸ‘®
:cop:	ğŸ‘®
:construction_worker:	ğŸ‘·
:guard:	ğŸ’‚
:guardsman:	ğŸ’‚
:detective:	ğŸ•µ
:spy:	ğŸ•µ
:sleuth_or_spy:	ğŸ•µ
:mrs_claus:	ğŸ¤¶
:mother_christmas:	ğŸ¤¶
:santa:	ğŸ…
:princess:	ğŸ‘¸
:prince:	ğŸ¤´
:bride_with_veil:	ğŸ‘°
:man_in_tuxedo:	ğŸ¤µ
:angel:	ğŸ‘¼
:pregnant_woman:	ğŸ¤°
:expecting_woman:	ğŸ¤°
:person_bowing:	ğŸ™‡
:bow:	ğŸ™‡
:person_tipping_hand:	ğŸ’
:information_desk_person:	ğŸ’
:person_gesturing_no:	ğŸ™…
:no_good:	ğŸ™…
:person_gesturing_ok:	ğŸ™†
:ok_woman:	ğŸ™†
:person_raising_hand:	ğŸ™‹
:raising_hand:	ğŸ™‹
:person_facepalming:	ğŸ¤¦
:face_palm:	ğŸ¤¦
:facepalm:	ğŸ¤¦
:person_shrugging:	ğŸ¤·
:shrug:	ğŸ¤·
:person_pouting:	ğŸ™
:person_with_pouting_face:	ğŸ™
:person_frowning:	ğŸ™
:person_getting_haircut:	ğŸ’‡
:haircut:	ğŸ’‡
:person_getting_massage:	ğŸ’†
:massage:	ğŸ’†
:levitate:	ğŸ•´
:dancer:	ğŸ’ƒ
:man_dancing:	ğŸ•º
:male_dancer:	ğŸ•º
:people_with_bunny_ears_partying:	ğŸ‘¯
:dancers:	ğŸ‘¯
:person_walking:	ğŸš¶
:walking:	ğŸš¶
:person_running:	ğŸƒ
:runner:	ğŸƒ
:couple:	ğŸ‘«
:two_women_holding_hands:	ğŸ‘­
:two_men_holding_hands:	ğŸ‘¬
:couple_with_heart:	ğŸ’‘
:couplekiss:	ğŸ’
:family:	ğŸ‘ª
:womans_clothes:	ğŸ‘š
:shirt:	ğŸ‘•
:jeans:	ğŸ‘–
:necktie:	ğŸ‘”
:dress:	ğŸ‘—
:bikini:	ğŸ‘™
:kimono:	ğŸ‘˜
:high_heel:	ğŸ‘ 
:sandal:	ğŸ‘¡
:boot:	ğŸ‘¢
:mans_shoe:	ğŸ‘
:athletic_shoe:	ğŸ‘Ÿ
:womans_hat:	ğŸ‘’
:tophat:	ğŸ©
:mortar_board:	ğŸ“
:crown:	ğŸ‘‘
:helmet_with_cross:	â›‘
:helmet_with_white_cross:	â›‘
:school_satchel:	ğŸ’
:pouch:	ğŸ‘
:purse:	ğŸ‘›
:handbag:	ğŸ‘œ
:briefcase:	ğŸ’¼
:eyeglasses:	ğŸ‘“
:dark_sunglasses:	ğŸ•¶
:closed_umbrella:	ğŸŒ‚
:umbrella2:	â˜‚
:dog:	ğŸ¶
:cat:	ğŸ±
:mouse:	ğŸ­
:hamster:	ğŸ¹
:rabbit:	ğŸ°
:fox:	ğŸ¦Š
:fox_face:	ğŸ¦Š
:bear:	ğŸ»
:panda_face:	ğŸ¼
:koala:	ğŸ¨
:tiger:	ğŸ¯
:lion_face:	ğŸ¦
:lion:	ğŸ¦
:cow:	ğŸ®
:pig:	ğŸ·
:pig_nose:	ğŸ½
:frog:	ğŸ¸
:monkey_face:	ğŸµ
:see_no_evil:	ğŸ™ˆ
:hear_no_evil:	ğŸ™‰
:speak_no_evil:	ğŸ™Š
:monkey:	ğŸ’
:chicken:	ğŸ”
:penguin:	ğŸ§
:bird:	ğŸ¦
:baby_chick:	ğŸ¤
:hatching_chick:	ğŸ£
:hatched_chick:	ğŸ¥
:duck:	ğŸ¦†
:eagle:	ğŸ¦…
:owl:	ğŸ¦‰
:bat:	ğŸ¦‡
:wolf:	ğŸº
:boar:	ğŸ—
:horse:	ğŸ´
:unicorn:	ğŸ¦„
:unicorn_face:	ğŸ¦„
:bee:	ğŸ
:bug:	ğŸ›
:butterfly:	ğŸ¦‹
:snail:	ğŸŒ
:shell:	ğŸš
:beetle:	ğŸ
:ant:	ğŸœ
:spider:	ğŸ•·
:spider_web:	ğŸ•¸
:turtle:	ğŸ¢
:snake:	ğŸ
:lizard:	ğŸ¦
:scorpion:	ğŸ¦‚
:crab:	ğŸ¦€
:squid:	ğŸ¦‘
:octopus:	ğŸ™
:shrimp:	ğŸ¦
:tropical_fish:	ğŸ 
:fish:	ğŸŸ
:blowfish:	ğŸ¡
:dolphin:	ğŸ¬
:shark:	ğŸ¦ˆ
:whale:	ğŸ³
:whale2:	ğŸ‹
:crocodile:	ğŸŠ
:leopard:	ğŸ†
:tiger2:	ğŸ…
:water_buffalo:	ğŸƒ
:ox:	ğŸ‚
:cow2:	ğŸ„
:deer:	ğŸ¦Œ
:dromedary_camel:	ğŸª
:camel:	ğŸ«
:elephant:	ğŸ˜
:rhino:	ğŸ¦
:rhinoceros:	ğŸ¦
:gorilla:	ğŸ¦
:racehorse:	ğŸ
:pig2:	ğŸ–
:goat:	ğŸ
:ram:	ğŸ
:sheep:	ğŸ‘
:dog2:	ğŸ•
:poodle:	ğŸ©
:cat2:	ğŸˆ
:rooster:	ğŸ“
:turkey:	ğŸ¦ƒ
:dove:	ğŸ•Š
:dove_of_peace:	ğŸ•Š
:rabbit2:	ğŸ‡
:mouse2:	ğŸ
:rat:	ğŸ€
:chipmunk:	ğŸ¿
:feet:	ğŸ¾
:paw_prints:	ğŸ¾
:dragon:	ğŸ‰
:dragon_face:	ğŸ²
:cactus:	ğŸŒµ
:christmas_tree:	ğŸ„
:evergreen_tree:	ğŸŒ²
:deciduous_tree:	ğŸŒ³
:palm_tree:	ğŸŒ´
:seedling:	ğŸŒ±
:herb:	ğŸŒ¿
:shamrock:	â˜˜
:four_leaf_clover:	ğŸ€
:bamboo:	ğŸ
:tanabata_tree:	ğŸ‹
:leaves:	ğŸƒ
:fallen_leaf:	ğŸ‚
:maple_leaf:	ğŸ
:mushroom:	ğŸ„
:ear_of_rice:	ğŸŒ¾
:bouquet:	ğŸ’
:tulip:	ğŸŒ·
:rose:	ğŸŒ¹
:wilted_rose:	ğŸ¥€
:wilted_flower:	ğŸ¥€
:sunflower:	ğŸŒ»
:blossom:	ğŸŒ¼
:cherry_blossom:	ğŸŒ¸
:hibiscus:	ğŸŒº
:earth_americas:	ğŸŒ
:earth_africa:	ğŸŒ
:earth_asia:	ğŸŒ
:full_moon:	ğŸŒ•
:waning_gibbous_moon:	ğŸŒ–
:last_quarter_moon:	ğŸŒ—
:waning_crescent_moon:	ğŸŒ˜
:new_moon:	ğŸŒ‘
:waxing_crescent_moon:	ğŸŒ’
:first_quarter_moon:	ğŸŒ“
:waxing_gibbous_moon:	ğŸŒ”
:new_moon_with_face:	ğŸŒš
:full_moon_with_face:	ğŸŒ
:sun_with_face:	ğŸŒ
:first_quarter_moon_with_face:	ğŸŒ›
:last_quarter_moon_with_face:	ğŸŒœ
:crescent_moon:	ğŸŒ™
:dizzy:	ğŸ’«
:star:	â­
:star2:	ğŸŒŸ
:sparkles:	âœ¨
:zap:	âš¡
:fire:	ğŸ”¥
:flame:	ğŸ”¥
:boom:	ğŸ’¥
:comet:	â˜„
:sunny:	â˜€
:white_sun_small_cloud:	ğŸŒ¤
:white_sun_with_small_cloud:	ğŸŒ¤
:partly_sunny:	â›…
:white_sun_cloud:	ğŸŒ¥
:white_sun_behind_cloud:	ğŸŒ¥
:white_sun_rain_cloud:	ğŸŒ¦
:white_sun_behind_cloud_with_rain:	ğŸŒ¦
:rainbow:	ğŸŒˆ
:cloud:	â˜
:cloud_rain:	ğŸŒ§
:cloud_with_rain:	ğŸŒ§
:thunder_cloud_rain:	â›ˆ
:thunder_cloud_and_rain:	â›ˆ
:cloud_lightning:	ğŸŒ©
:cloud_with_lightning:	ğŸŒ©
:cloud_snow:	ğŸŒ¨
:cloud_with_snow:	ğŸŒ¨
:snowman2:	â˜ƒ
:snowman:	â›„
:snowflake:	â„
:wind_blowing_face:	ğŸŒ¬
:dash:	ğŸ’¨
:cloud_tornado:	ğŸŒª
:cloud_with_tornado:	ğŸŒª
:fog:	ğŸŒ«
:ocean:	ğŸŒŠ
:droplet:	ğŸ’§
:sweat_drops:	ğŸ’¦
:umbrella:	â˜”
:giraffe:	ğŸ¦’
:zebra:	ğŸ¦“
:hedgehog:	ğŸ¦”
:sauropod:	ğŸ¦•
:t_rex:	ğŸ¦–
:cricket:	ğŸ¦—
:green_apple:	ğŸ
:apple:	ğŸ
:pear:	ğŸ
:tangerine:	ğŸŠ
:lemon:	ğŸ‹
:banana:	ğŸŒ
:watermelon:	ğŸ‰
:grapes:	ğŸ‡
:strawberry:	ğŸ“
:melon:	ğŸˆ
:cherries:	ğŸ’
:peach:	ğŸ‘
:pineapple:	ğŸ
:kiwi:	ğŸ¥
:kiwifruit:	ğŸ¥
:avocado:	ğŸ¥‘
:tomato:	ğŸ…
:eggplant:	ğŸ†
:cucumber:	ğŸ¥’
:carrot:	ğŸ¥•
:corn:	ğŸŒ½
:hot_pepper:	ğŸŒ¶
:potato:	ğŸ¥”
:sweet_potato:	ğŸ 
:chestnut:	ğŸŒ°
:peanuts:	ğŸ¥œ
:shelled_peanut:	ğŸ¥œ
:honey_pot:	ğŸ¯
:croissant:	ğŸ¥
:bread:	ğŸ
:french_bread:	ğŸ¥–
:baguette_bread:	ğŸ¥–
:cheese:	ğŸ§€
:cheese_wedge:	ğŸ§€
:egg:	ğŸ¥š
:cooking:	ğŸ³
:bacon:	ğŸ¥“
:pancakes:	ğŸ¥
:fried_shrimp:	ğŸ¤
:poultry_leg:	ğŸ—
:meat_on_bone:	ğŸ–
:pizza:	ğŸ•
:hotdog:	ğŸŒ­
:hot_dog:	ğŸŒ­
:hamburger:	ğŸ”
:fries:	ğŸŸ
:stuffed_flatbread:	ğŸ¥™
:stuffed_pita:	ğŸ¥™
:taco:	ğŸŒ®
:burrito:	ğŸŒ¯
:salad:	ğŸ¥—
:green_salad:	ğŸ¥—
:shallow_pan_of_food:	ğŸ¥˜
:paella:	ğŸ¥˜
:spaghetti:	ğŸ
:ramen:	ğŸœ
:stew:	ğŸ²
:fish_cake:	ğŸ¥
:sushi:	ğŸ£
:bento:	ğŸ±
:curry:	ğŸ›
:rice_ball:	ğŸ™
:rice:	ğŸš
:rice_cracker:	ğŸ˜
:oden:	ğŸ¢
:dango:	ğŸ¡
:shaved_ice:	ğŸ§
:ice_cream:	ğŸ¨
:icecream:	ğŸ¦
:cake:	ğŸ°
:birthday:	ğŸ‚
:custard:	ğŸ®
:pudding:	ğŸ®
:flan:	ğŸ®
:lollipop:	ğŸ­
:candy:	ğŸ¬
:chocolate_bar:	ğŸ«
:popcorn:	ğŸ¿
:doughnut:	ğŸ©
:cookie:	ğŸª
:milk:	ğŸ¥›
:glass_of_milk:	ğŸ¥›
:baby_bottle:	ğŸ¼
:coffee:	â˜•
:tea:	ğŸµ
:sake:	ğŸ¶
:beer:	ğŸº
:beers:	ğŸ»
:champagne_glass:	ğŸ¥‚
:clinking_glass:	ğŸ¥‚
:wine_glass:	ğŸ·
:tumbler_glass:	ğŸ¥ƒ
:whisky:	ğŸ¥ƒ
:cocktail:	ğŸ¸
:tropical_drink:	ğŸ¹
:champagne:	ğŸ¾
:bottle_with_popping_cork:	ğŸ¾
:spoon:	ğŸ¥„
:fork_and_knife:	ğŸ´
:fork_knife_plate:	ğŸ½
:fork_and_knife_with_plate:	ğŸ½
:dumpling:	ğŸ¥Ÿ
:fortune_cookie:	ğŸ¥ 
:takeout_box:	ğŸ¥¡
:chopsticks:	ğŸ¥¢
:bowl_with_spoon:	ğŸ¥£
:cup_with_straw:	ğŸ¥¤
:coconut:	ğŸ¥¥
:broccoli:	ğŸ¥¦
:pie:	ğŸ¥§
:pretzel:	ğŸ¥¨
:cut_of_meat:	ğŸ¥©
:sandwich:	ğŸ¥ª
:canned_food:	ğŸ¥«
:soccer:	âš½
:basketball:	ğŸ€
:football:	ğŸˆ
:baseball:	âš¾
:tennis:	ğŸ¾
:volleyball:	ğŸ
:rugby_football:	ğŸ‰
:8ball:	ğŸ±
:ping_pong:	ğŸ“
:table_tennis:	ğŸ“
:badminton:	ğŸ¸
:goal:	ğŸ¥…
:goal_net:	ğŸ¥…
:hockey:	ğŸ’
:field_hockey:	ğŸ‘
:cricket_game:	ğŸ
:cricket_bat_ball:	ğŸ
:golf:	â›³
:bow_and_arrow:	ğŸ¹
:archery:	ğŸ¹
:fishing_pole_and_fish:	ğŸ£
:boxing_glove:	ğŸ¥Š
:boxing_gloves:	ğŸ¥Š
:martial_arts_uniform:	ğŸ¥‹
:karate_uniform:	ğŸ¥‹
:ice_skate:	â›¸
:ski:	ğŸ¿
:skier:	â›·
:snowboarder:	ğŸ‚
:person_lifting_weights:	ğŸ‹
:lifter:	ğŸ‹
:weight_lifter:	ğŸ‹
:person_fencing:	ğŸ¤º
:fencer:	ğŸ¤º
:fencing:	ğŸ¤º
:people_wrestling:	ğŸ¤¼
:wrestlers:	ğŸ¤¼
:wrestling:	ğŸ¤¼
:person_doing_cartwheel:	ğŸ¤¸
:cartwheel:	ğŸ¤¸
:person_bouncing_ball:	â›¹
:basketball_player:	â›¹
:person_with_ball:	â›¹
:person_playing_handball:	ğŸ¤¾
:handball:	ğŸ¤¾
:person_golfing:	ğŸŒ
:golfer:	ğŸŒ
:person_surfing:	ğŸ„
:surfer:	ğŸ„
:person_swimming:	ğŸŠ
:swimmer:	ğŸŠ
:person_playing_water_polo:	ğŸ¤½
:water_polo:	ğŸ¤½
:person_rowing_boat:	ğŸš£
:rowboat:	ğŸš£
:horse_racing:	ğŸ‡
:person_biking:	ğŸš´
:bicyclist:	ğŸš´
:person_mountain_biking:	ğŸšµ
:mountain_bicyclist:	ğŸšµ
:running_shirt_with_sash:	ğŸ½
:medal:	ğŸ…
:sports_medal:	ğŸ…
:military_medal:	ğŸ–
:first_place:	ğŸ¥‡
:first_place_medal:	ğŸ¥‡
:second_place:	ğŸ¥ˆ
:second_place_medal:	ğŸ¥ˆ
:third_place:	ğŸ¥‰
:third_place_medal:	ğŸ¥‰
:trophy:	ğŸ†
:rosette:	ğŸµ
:reminder_ribbon:	ğŸ—
:ticket:	ğŸ«
:tickets:	ğŸŸ
:admission_tickets:	ğŸŸ
:circus_tent:	ğŸª
:person_juggling:	ğŸ¤¹
:juggling:	ğŸ¤¹
:juggler:	ğŸ¤¹
:performing_arts:	ğŸ­
:art:	ğŸ¨
:clapper:	ğŸ¬
:microphone:	ğŸ¤
:headphones:	ğŸ§
:musical_score:	ğŸ¼
:musical_keyboard:	ğŸ¹
:drum:	ğŸ¥
:drum_with_drumsticks:	ğŸ¥
:saxophone:	ğŸ·
:trumpet:	ğŸº
:guitar:	ğŸ¸
:violin:	ğŸ»
:game_die:	ğŸ²
:dart:	ğŸ¯
:bowling:	ğŸ³
:video_game:	ğŸ®
:slot_machine:	ğŸ°
:sled:	ğŸ›·
:breast_feeding:	ğŸ¤±
:curling_stone:	ğŸ¥Œ
:person_in_steamy_room:	ğŸ§–
:person_climbing:	ğŸ§—
:person_in_lotus_position:	ğŸ§˜
:red_car:	ğŸš—
:taxi:	ğŸš•
:blue_car:	ğŸš™
:bus:	ğŸšŒ
:trolleybus:	ğŸš
:race_car:	ğŸ
:racing_car:	ğŸ
:police_car:	ğŸš“
:ambulance:	ğŸš‘
:fire_engine:	ğŸš’
:minibus:	ğŸš
:truck:	ğŸšš
:articulated_lorry:	ğŸš›
:tractor:	ğŸšœ
:scooter:	ğŸ›´
:bike:	ğŸš²
:motor_scooter:	ğŸ›µ
:motorbike:	ğŸ›µ
:motorcycle:	ğŸ
:racing_motorcycle:	ğŸ
:rotating_light:	ğŸš¨
:oncoming_police_car:	ğŸš”
:oncoming_bus:	ğŸš
:oncoming_automobile:	ğŸš˜
:oncoming_taxi:	ğŸš–
:aerial_tramway:	ğŸš¡
:mountain_cableway:	ğŸš 
:suspension_railway:	ğŸšŸ
:railway_car:	ğŸšƒ
:train:	ğŸš‹
:mountain_railway:	ğŸš
:monorail:	ğŸš
:bullettrain_side:	ğŸš„
:bullettrain_front:	ğŸš…
:light_rail:	ğŸšˆ
:steam_locomotive:	ğŸš‚
:train2:	ğŸš†
:metro:	ğŸš‡
:tram:	ğŸšŠ
:station:	ğŸš‰
:helicopter:	ğŸš
:airplane_small:	ğŸ›©
:small_airplane:	ğŸ›©
:airplane:	âœˆ
:airplane_departure:	ğŸ›«
:airplane_arriving:	ğŸ›¬
:rocket:	ğŸš€
:satellite_orbital:	ğŸ›°
:seat:	ğŸ’º
:canoe:	ğŸ›¶
:kayak:	ğŸ›¶
:sailboat:	â›µ
:motorboat:	ğŸ›¥
:speedboat:	ğŸš¤
:cruise_ship:	ğŸ›³
:passenger_ship:	ğŸ›³
:ferry:	â›´
:ship:	ğŸš¢
:anchor:	âš“
:construction:	ğŸš§
:fuelpump:	â›½
:busstop:	ğŸš
:vertical_traffic_light:	ğŸš¦
:traffic_light:	ğŸš¥
:map:	ğŸ—º
:world_map:	ğŸ—º
:moyai:	ğŸ—¿
:statue_of_liberty:	ğŸ—½
:fountain:	â›²
:tokyo_tower:	ğŸ—¼
:european_castle:	ğŸ°
:japanese_castle:	ğŸ¯
:stadium:	ğŸŸ
:ferris_wheel:	ğŸ¡
:roller_coaster:	ğŸ¢
:carousel_horse:	ğŸ 
:beach_umbrella:	â›±
:umbrella_on_ground:	â›±
:beach:	ğŸ–
:beach_with_umbrella:	ğŸ–
:island:	ğŸ
:desert_island:	ğŸ
:mountain:	â›°
:mountain_snow:	ğŸ”
:snow_capped_mountain:	ğŸ”
:mount_fuji:	ğŸ—»
:volcano:	ğŸŒ‹
:desert:	ğŸœ
:camping:	ğŸ•
:tent:	â›º
:railway_track:	ğŸ›¤
:railroad_track:	ğŸ›¤
:motorway:	ğŸ›£
:construction_site:	ğŸ—
:building_construction:	ğŸ—
:factory:	ğŸ­
:house:	ğŸ 
:house_with_garden:	ğŸ¡
:homes:	ğŸ˜
:house_buildings:	ğŸ˜
:house_abandoned:	ğŸš
:derelict_house_building:	ğŸš
:office:	ğŸ¢
:department_store:	ğŸ¬
:post_office:	ğŸ£
:european_post_office:	ğŸ¤
:hospital:	ğŸ¥
:bank:	ğŸ¦
:hotel:	ğŸ¨
:convenience_store:	ğŸª
:school:	ğŸ«
:love_hotel:	ğŸ©
:wedding:	ğŸ’’
:classical_building:	ğŸ›
:church:	â›ª
:mosque:	ğŸ•Œ
:synagogue:	ğŸ•
:kaaba:	ğŸ•‹
:shinto_shrine:	â›©
:japan:	ğŸ—¾
:rice_scene:	ğŸ‘
:park:	ğŸ
:national_park:	ğŸ
:sunrise:	ğŸŒ…
:sunrise_over_mountains:	ğŸŒ„
:stars:	ğŸŒ 
:sparkler:	ğŸ‡
:fireworks:	ğŸ†
:city_sunset:	ğŸŒ‡
:city_sunrise:	ğŸŒ‡
:city_dusk:	ğŸŒ†
:cityscape:	ğŸ™
:night_with_stars:	ğŸŒƒ
:milky_way:	ğŸŒŒ
:bridge_at_night:	ğŸŒ‰
:foggy:	ğŸŒ
:flying_saucer:	ğŸ›¸
:watch:	âŒš
:iphone:	ğŸ“±
:calling:	ğŸ“²
:computer:	ğŸ’»
:keyboard:	âŒ¨
:desktop:	ğŸ–¥
:desktop_computer:	ğŸ–¥
:printer:	ğŸ–¨
:mouse_three_button:	ğŸ–±
:three_button_mouse:	ğŸ–±
:trackball:	ğŸ–²
:joystick:	ğŸ•¹
:compression:	ğŸ—œ
:minidisc:	ğŸ’½
:floppy_disk:	ğŸ’¾
:cd:	ğŸ’¿
:dvd:	ğŸ“€
:vhs:	ğŸ“¼
:camera:	ğŸ“·
:camera_with_flash:	ğŸ“¸
:video_camera:	ğŸ“¹
:movie_camera:	ğŸ¥
:projector:	ğŸ“½
:film_projector:	ğŸ“½
:film_frames:	ğŸ
:telephone_receiver:	ğŸ“
:telephone:	â˜
:pager:	ğŸ“Ÿ
:fax:	ğŸ“ 
:tv:	ğŸ“º
:radio:	ğŸ“»
:microphone2:	ğŸ™
:studio_microphone:	ğŸ™
:level_slider:	ğŸš
:control_knobs:	ğŸ›
:stopwatch:	â±
:timer:	â²
:timer_clock:	â²
:alarm_clock:	â°
:clock:	ğŸ•°
:mantlepiece_clock:	ğŸ•°
:hourglass:	âŒ›
:hourglass_flowing_sand:	â³
:satellite:	ğŸ“¡
:battery:	ğŸ”‹
:electric_plug:	ğŸ”Œ
:bulb:	ğŸ’¡
:flashlight:	ğŸ”¦
:candle:	ğŸ•¯
:wastebasket:	ğŸ—‘
:oil:	ğŸ›¢
:oil_drum:	ğŸ›¢
:money_with_wings:	ğŸ’¸
:dollar:	ğŸ’µ
:yen:	ğŸ’´
:euro:	ğŸ’¶
:pound:	ğŸ’·
:moneybag:	ğŸ’°
:credit_card:	ğŸ’³
:gem:	ğŸ’
:scales:	âš–
:wrench:	ğŸ”§
:hammer:	ğŸ”¨
:hammer_pick:	âš’
:hammer_and_pick:	âš’
:tools:	ğŸ› 
:hammer_and_wrench:	ğŸ› 
:pick:	â›
:nut_and_bolt:	ğŸ”©
:gear:	âš™
:chains:	â›“
:gun:	ğŸ”«
:bomb:	ğŸ’£
:knife:	ğŸ”ª
:dagger:	ğŸ—¡
:dagger_knife:	ğŸ—¡
:crossed_swords:	âš”
:shield:	ğŸ›¡
:smoking:	ğŸš¬
:coffin:	âš°
:urn:	âš±
:funeral_urn:	âš±
:amphora:	ğŸº
:crystal_ball:	ğŸ”®
:prayer_beads:	ğŸ“¿
:barber:	ğŸ’ˆ
:alembic:	âš—
:telescope:	ğŸ”­
:microscope:	ğŸ”¬
:hole:	ğŸ•³
:pill:	ğŸ’Š
:syringe:	ğŸ’‰
:thermometer:	ğŸŒ¡
:toilet:	ğŸš½
:potable_water:	ğŸš°
:shower:	ğŸš¿
:bathtub:	ğŸ›
:bath:	ğŸ›€
:bellhop:	ğŸ›
:bellhop_bell:	ğŸ›
:key:	ğŸ”‘
:key2:	ğŸ—
:old_key:	ğŸ—
:door:	ğŸšª
:couch:	ğŸ›‹
:couch_and_lamp:	ğŸ›‹
:bed:	ğŸ›
:sleeping_accommodation:	ğŸ›Œ
:frame_photo:	ğŸ–¼
:frame_with_picture:	ğŸ–¼
:shopping_bags:	ğŸ›
:shopping_cart:	ğŸ›’
:shopping_trolley:	ğŸ›’
:gift:	ğŸ
:balloon:	ğŸˆ
:flags:	ğŸ
:ribbon:	ğŸ€
:confetti_ball:	ğŸŠ
:tada:	ğŸ‰
:dolls:	ğŸ
:izakaya_lantern:	ğŸ®
:wind_chime:	ğŸ
:envelope:	âœ‰
:envelope_with_arrow:	ğŸ“©
:incoming_envelope:	ğŸ“¨
:e-mail:	ğŸ“§
:email:	ğŸ“§
:love_letter:	ğŸ’Œ
:inbox_tray:	ğŸ“¥
:outbox_tray:	ğŸ“¤
:package:	ğŸ“¦
:label:	ğŸ·
:mailbox_closed:	ğŸ“ª
:mailbox:	ğŸ“«
:mailbox_with_mail:	ğŸ“¬
:mailbox_with_no_mail:	ğŸ“­
:postbox:	ğŸ“®
:postal_horn:	ğŸ“¯
:scroll:	ğŸ“œ
:page_with_curl:	ğŸ“ƒ
:page_facing_up:	ğŸ“„
:bookmark_tabs:	ğŸ“‘
:bar_chart:	ğŸ“Š
:chart_with_upwards_trend:	ğŸ“ˆ
:chart_with_downwards_trend:	ğŸ“‰
:notepad_spiral:	ğŸ—’
:spiral_note_pad:	ğŸ—’
:calendar_spiral:	ğŸ—“
:spiral_calendar_pad:	ğŸ—“
:calendar:	ğŸ“†
:date:	ğŸ“…
:card_index:	ğŸ“‡
:card_box:	ğŸ—ƒ
:card_file_box:	ğŸ—ƒ
:ballot_box:	ğŸ—³
:ballot_box_with_ballot:	ğŸ—³
:file_cabinet:	ğŸ—„
:clipboard:	ğŸ“‹
:file_folder:	ğŸ“
:open_file_folder:	ğŸ“‚
:dividers:	ğŸ—‚
:card_index_dividers:	ğŸ—‚
:newspaper2:	ğŸ—
:rolled_up_newspaper:	ğŸ—
:newspaper:	ğŸ“°
:notebook:	ğŸ““
:notebook_with_decorative_cover:	ğŸ“”
:ledger:	ğŸ“’
:closed_book:	ğŸ“•
:green_book:	ğŸ“—
:blue_book:	ğŸ“˜
:orange_book:	ğŸ“™
:books:	ğŸ“š
:book:	ğŸ“–
:bookmark:	ğŸ”–
:link:	ğŸ”—
:paperclip:	ğŸ“
:paperclips:	ğŸ–‡
:linked_paperclips:	ğŸ–‡
:triangular_ruler:	ğŸ“
:straight_ruler:	ğŸ“
:pushpin:	ğŸ“Œ
:round_pushpin:	ğŸ“
:scissors:	âœ‚
:pen_ballpoint:	ğŸ–Š
:lower_left_ballpoint_pen:	ğŸ–Š
:pen_fountain:	ğŸ–‹
:lower_left_fountain_pen:	ğŸ–‹
:black_nib:	âœ’
:paintbrush:	ğŸ–Œ
:lower_left_paintbrush:	ğŸ–Œ
:crayon:	ğŸ–
:lower_left_crayon:	ğŸ–
:pencil:	ğŸ“
:memo:	ğŸ“
:pencil2:	âœ
:mag:	ğŸ”
:mag_right:	ğŸ”
:lock_with_ink_pen:	ğŸ”
:closed_lock_with_key:	ğŸ”
:lock:	ğŸ”’
:unlock:	ğŸ”“
:orange_heart:	ğŸ§¡
:heart:	â¤
:yellow_heart:	ğŸ’›
:green_heart:	ğŸ’š
:blue_heart:	ğŸ’™
:purple_heart:	ğŸ’œ
:black_heart:	ğŸ–¤
:broken_heart:	ğŸ’”
:heart_exclamation:	â£
:heavy_heart_exclamation_mark_ornament:	â£
:two_hearts:	ğŸ’•
:revolving_hearts:	ğŸ’
:heartbeat:	ğŸ’“
:heartpulse:	ğŸ’—
:sparkling_heart:	ğŸ’–
:cupid:	ğŸ’˜
:gift_heart:	ğŸ’
:heart_decoration:	ğŸ’Ÿ
:peace:	â˜®
:peace_symbol:	â˜®
:cross:	âœ
:latin_cross:	âœ
:star_and_crescent:	â˜ª
:om_symbol:	ğŸ•‰
:wheel_of_dharma:	â˜¸
:star_of_david:	âœ¡
:six_pointed_star:	ğŸ”¯
:menorah:	ğŸ•
:yin_yang:	â˜¯
:orthodox_cross:	â˜¦
:place_of_worship:	ğŸ›
:worship_symbol:	ğŸ›
:ophiuchus:	â›
:aries:	â™ˆ
:taurus:	â™‰
:gemini:	â™Š
:cancer:	â™‹
:leo:	â™Œ
:virgo:	â™
:libra:	â™
:scorpius:	â™
:sagittarius:	â™
:capricorn:	â™‘
:aquarius:	â™’
:pisces:	â™“
:id:	ğŸ†”
:atom:	âš›
:atom_symbol:	âš›
:accept:	ğŸ‰‘
:radioactive:	â˜¢
:radioactive_sign:	â˜¢
:biohazard:	â˜£
:biohazard_sign:	â˜£
:mobile_phone_off:	ğŸ“´
:vibration_mode:	ğŸ“³
:u6709:	ğŸˆ¶
:u7121:	ğŸˆš
:u7533:	ğŸˆ¸
:u55b6:	ğŸˆº
:u6708:	ğŸˆ·
:eight_pointed_black_star:	âœ´
:vs:	ğŸ†š
:white_flower:	ğŸ’®
:ideograph_advantage:	ğŸ‰
:secret:	ãŠ™
:congratulations:	ãŠ—
:u5408:	ğŸˆ´
:u6e80:	ğŸˆµ
:u5272:	ğŸˆ¹
:u7981:	ğŸˆ²
:a:	ğŸ…°
:b:	ğŸ…±
:ab:	ğŸ†
:cl:	ğŸ†‘
:o2:	ğŸ…¾
:sos:	ğŸ†˜
:x:	âŒ
:o:	â­•
:octagonal_sign:	ğŸ›‘
:stop_sign:	ğŸ›‘
:no_entry:	â›”
:name_badge:	ğŸ“›
:no_entry_sign:	ğŸš«
:100:	ğŸ’¯
:anger:	ğŸ’¢
:hotsprings:	â™¨
:no_pedestrians:	ğŸš·
:do_not_litter:	ğŸš¯
:no_bicycles:	ğŸš³
:non-potable_water:	ğŸš±
:underage:	ğŸ”
:no_mobile_phones:	ğŸ“µ
:no_smoking:	ğŸš­
:exclamation:	â—
:grey_exclamation:	â•
:question:	â“
:grey_question:	â”
:bangbang:	â€¼
:interrobang:	â‰
:low_brightness:	ğŸ”…
:high_brightness:	ğŸ”†
:part_alternation_mark:	ã€½
:warning:	âš 
:children_crossing:	ğŸš¸
:trident:	ğŸ”±
:fleur-de-lis:	âšœ
:beginner:	ğŸ”°
:recycle:	â™»
:white_check_mark:	âœ…
:u6307:	ğŸˆ¯
:chart:	ğŸ’¹
:sparkle:	â‡
:eight_spoked_asterisk:	âœ³
:negative_squared_cross_mark:	â
:globe_with_meridians:	ğŸŒ
:diamond_shape_with_a_dot_inside:	ğŸ’ 
:m:	â“‚
:cyclone:	ğŸŒ€
:zzz:	ğŸ’¤
:atm:	ğŸ§
:wc:	ğŸš¾
:wheelchair:	â™¿
:parking:	ğŸ…¿
:u7a7a:	ğŸˆ³
:sa:	ğŸˆ‚
:passport_control:	ğŸ›‚
:customs:	ğŸ›ƒ
:baggage_claim:	ğŸ›„
:left_luggage:	ğŸ›…
:mens:	ğŸš¹
:womens:	ğŸšº
:baby_symbol:	ğŸš¼
:restroom:	ğŸš»
:put_litter_in_its_place:	ğŸš®
:cinema:	ğŸ¦
:signal_strength:	ğŸ“¶
:koko:	ğŸˆ
:symbols:	ğŸ”£
:information_source:	â„¹
:abc:	ğŸ”¤
:abcd:	ğŸ”¡
:capital_abcd:	ğŸ” 
:ng:	ğŸ†–
:ok:	ğŸ†—
:up:	ğŸ†™
:cool:	ğŸ†’
:new:	ğŸ†•
:free:	ğŸ†“
:keycap_ten:	ğŸ”Ÿ
:1234:	ğŸ”¢
:arrow_forward:	â–¶
:pause_button:	â¸
:double_vertical_bar:	â¸
:play_pause:	â¯
:stop_button:	â¹
:record_button:	âº
:eject:	â
:eject_symbol:	â
:track_next:	â­
:next_track:	â­
:track_previous:	â®
:previous_track:	â®
:fast_forward:	â©
:rewind:	âª
:arrow_double_up:	â«
:arrow_double_down:	â¬
:arrow_backward:	â—€
:arrow_up_small:	ğŸ”¼
:arrow_down_small:	ğŸ”½
:arrow_right:	â¡
:arrow_left:	â¬…
:arrow_up:	â¬†
:arrow_down:	â¬‡
:arrow_upper_right:	â†—
:arrow_lower_right:	â†˜
:arrow_lower_left:	â†™
:arrow_upper_left:	â†–
:arrow_up_down:	â†•
:left_right_arrow:	â†”
:arrow_right_hook:	â†ª
:leftwards_arrow_with_hook:	â†©
:arrow_heading_up:	â¤´
:arrow_heading_down:	â¤µ
:twisted_rightwards_arrows:	ğŸ”€
:repeat:	ğŸ”
:repeat_one:	ğŸ”‚
:arrows_counterclockwise:	ğŸ”„
:arrows_clockwise:	ğŸ”ƒ
:musical_note:	ğŸµ
:notes:	ğŸ¶
:heavy_plus_sign:	â•
:heavy_minus_sign:	â–
:heavy_division_sign:	â—
:heavy_multiplication_x:	âœ–
:heavy_dollar_sign:	ğŸ’²
:currency_exchange:	ğŸ’±
:tm:	â„¢
:copyright:	Â©
:registered:	Â®
:wavy_dash:	ã€°
:curly_loop:	â°
:loop:	â¿
:end:	ğŸ”š
:back:	ğŸ”™
:on:	ğŸ”›
:top:	ğŸ”
:soon:	ğŸ”œ
:heavy_check_mark:	âœ”
:ballot_box_with_check:	â˜‘
:radio_button:	ğŸ”˜
:white_circle:	âšª
:black_circle:	âš«
:red_circle:	ğŸ”´
:blue_circle:	ğŸ”µ
:small_red_triangle:	ğŸ”º
:small_red_triangle_down:	ğŸ”»
:small_orange_diamond:	ğŸ”¸
:small_blue_diamond:	ğŸ”¹
:large_orange_diamond:	ğŸ”¶
:large_blue_diamond:	ğŸ”·
:white_square_button:	ğŸ”³
:black_square_button:	ğŸ”²
:black_small_square:	â–ª
:white_small_square:	â–«
:black_medium_small_square:	â—¾
:white_medium_small_square:	â—½
:black_medium_square:	â—¼
:white_medium_square:	â—»
:black_large_square:	â¬›
:white_large_square:	â¬œ
:speaker:	ğŸ”ˆ
:mute:	ğŸ”‡
:sound:	ğŸ”‰
:loud_sound:	ğŸ”Š
:bell:	ğŸ””
:no_bell:	ğŸ”•
:mega:	ğŸ“£
:loudspeaker:	ğŸ“¢
:speech_left:	ğŸ—¨
:left_speech_bubble:	ğŸ—¨
:speech_balloon:	ğŸ’¬
:thought_balloon:	ğŸ’­
:anger_right:	ğŸ—¯
:right_anger_bubble:	ğŸ—¯
:spades:	â™ 
:clubs:	â™£
:hearts:	â™¥
:diamonds:	â™¦
:black_joker:	ğŸƒ
:flower_playing_cards:	ğŸ´
:mahjong:	ğŸ€„
:clock1:	ğŸ•
:clock2:	ğŸ•‘
:clock3:	ğŸ•’
:clock4:	ğŸ•“
:clock5:	ğŸ•”
:clock6:	ğŸ••
:clock7:	ğŸ•–
:clock8:	ğŸ•—
:clock9:	ğŸ•˜
:clock10:	ğŸ•™
:clock11:	ğŸ•š
:clock12:	ğŸ•›
:clock130:	ğŸ•œ
:clock230:	ğŸ•
:clock330:	ğŸ•
:clock430:	ğŸ•Ÿ
:clock530:	ğŸ• 
:clock630:	ğŸ•¡
:clock730:	ğŸ•¢
:clock830:	ğŸ•£
:clock930:	ğŸ•¤
:clock1030:	ğŸ•¥
:clock1130:	ğŸ•¦
:clock1230:	ğŸ•§
:flag_white:	ğŸ³
:waving_white_flag:	ğŸ³
:flag_black:	ğŸ´
:waving_black_flag:	ğŸ´
:checkered_flag:	ğŸ
:triangular_flag_on_post:	ğŸš©
:crossed_flags:	ğŸŒ
:asterisk_symbol:	*
:regional_indicator_z:	ğŸ‡¿
:regional_indicator_y:	ğŸ‡¾
:regional_indicator_x:	ğŸ‡½
:pound_symbol:	#
:tone1:	ğŸ»
:tone2:	ğŸ¼
:tone3:	ğŸ½
:tone4:	ğŸ¾
:tone5:	ğŸ¿
:regional_indicator_w:	ğŸ‡¼
:regional_indicator_v:	ğŸ‡»
:regional_indicator_u:	ğŸ‡º
:regional_indicator_t:	ğŸ‡¹
:regional_indicator_s:	ğŸ‡¸
:regional_indicator_r:	ğŸ‡·
:regional_indicator_q:	ğŸ‡¶
:regional_indicator_p:	ğŸ‡µ
:regional_indicator_o:	ğŸ‡´
:regional_indicator_n:	ğŸ‡³
:regional_indicator_m:	ğŸ‡²
:regional_indicator_l:	ğŸ‡±
:regional_indicator_k:	ğŸ‡°
:regional_indicator_j:	ğŸ‡¯
:regional_indicator_i:	ğŸ‡®
:regional_indicator_h:	ğŸ‡­
:regional_indicator_g:	ğŸ‡¬
:regional_indicator_f:	ğŸ‡«
:regional_indicator_e:	ğŸ‡ª
:regional_indicator_d:	ğŸ‡©
:regional_indicator_c:	ğŸ‡¨
:regional_indicator_b:	ğŸ‡§
:regional_indicator_a:	ğŸ‡¦
:digit_nine:	9
:digit_eight:	8
:digit_seven:	7
:digit_six:	6
:digit_five:	5
:digit_four:	4
:digit_three:	3
:digit_two:	2
:digit_one:	1
:digit_zero:	0
:female_sign:	â™€
:male_sign:	â™‚
:medical_symbol:	âš•
:face_with_raised_eyebrow:	ğŸ¤¨
:star_struck:	ğŸ¤©
:crazy_face:	ğŸ¤ª
:shushing_face:	ğŸ¤«
:face_with_symbols_over_mouth:	ğŸ¤¬
:face_with_hand_over_mouth:	ğŸ¤­
:face_vomiting:	ğŸ¤®
:exploding_head:	ğŸ¤¯
:face_with_monocle:	ğŸ§
:adult:	ğŸ§‘
:child:	ğŸ§’
:older_adult:	ğŸ§“
:bearded_person:	ğŸ§”
:woman_with_headscarf:	ğŸ§•
:brain:	ğŸ§ 
:billed_cap:	ğŸ§¢
:mage:	ğŸ§™
:fairy:	ğŸ§š
:vampire:	ğŸ§›
:merperson:	ğŸ§œ
:elf:	ğŸ§
:genie:	ğŸ§
:zombie:	ğŸ§Ÿ
:scarf:	ğŸ§£
:gloves:	ğŸ§¤
:coat:	ğŸ§¥
:socks:	ğŸ§¦
:love_you_gesture:	ğŸ¤Ÿ
:palms_up_together:	ğŸ¤²
