da	だ
di	ぢ
du	づ
de	で
do	ど
dya	ぢゃ
dyi	ぢぃ
dyu	ぢゅ
dye	ぢぇ
dyo	ぢょ
dha	でゃ
dhi	でぃ
d'i	でぃ
dhu	でゅ
dhe	でぇ
dho	でょ
d'yu	でゅ
dwa	どぁ
dwi	どぃ
dwu	どぅ
dwe	どぇ
dwo	どぉ
d'u	どぅ