ta	た
ti	ち
tu	つ
tsu	つ
te	て
to	と
tya	ちゃ
tyi	ちぃ
tyu	ちゅ
tye	ちぇ
tyo	ちょ

tsa	つぁ
tsi	つぃ
tse	つぇ
tso	つぉ
tha	てゃ
thi	てぃ
t'i	てぃ
thu	てゅ
the	てぇ
tho	てょ
t'yu	てゅ

twa	とぁ
twi	とぃ
twu	とぅ
twe	とぇ
two	とぉ
t'u	とぅ