:+1	ğŸ‘
:-1	ğŸ‘
:100	ğŸ’¯
:1234	ğŸ”¢
:8ball	ğŸ±
:ab:	ğŸ†
:abacus	ğŸ§®
:abc:	ğŸ”¤
:abcd	ğŸ”¡
:accept	ğŸ‰‘
:accordion	ğŸª—
:adhesive_bandage	ğŸ©¹
:adult	ğŸ§‘
:aerial_tramway	ğŸš¡
:airplane_arriving	ğŸ›¬
:airplane_departure	ğŸ›«
:alarm_clock	â°
:alien	ğŸ‘½
:ambulance	ğŸš‘
:amphora	ğŸº
:anatomical_heart	ğŸ«€
:anchor	âš“
:angel	ğŸ‘¼
:anger	ğŸ’¢
:angry	ğŸ˜ 
:anguished	ğŸ˜§
:ant	ğŸœ
:apple	ğŸ
:aquarius	â™’
:archery	ğŸ¹
:aries	â™ˆ
:arrow_double_down	â¬
:arrow_double_up	â«
:arrow_down_small	ğŸ”½
:arrow_up_small	ğŸ”¼
:arrows_clockwise	ğŸ”ƒ
:arrows_counterclockwise	ğŸ”„
:art:	ğŸ¨
:articulated_lorry	ğŸš›
:astonished	ğŸ˜²
:athletic_shoe	ğŸ‘Ÿ
:atm	ğŸ§
:auto_rickshaw	ğŸ›º
:avocado	ğŸ¥‘
:axe	ğŸª“
:baby:	ğŸ‘¶
:baby_bottle	ğŸ¼
:baby_chick	ğŸ¤
:baby_symbol	ğŸš¼
:back:	ğŸ”™
:back_of_hand	ğŸ¤š
:bacon	ğŸ¥“
:badger	ğŸ¦¡
:badminton	ğŸ¸
:bagel	ğŸ¥¯
:baggage_claim	ğŸ›„
:baguette_bread	ğŸ¥–
:bald	ğŸ¦²
:ballet_shoes	ğŸ©°
:balloon	ğŸˆ
:bamboo	ğŸ
:banana	ğŸŒ
:banjo	ğŸª•
:bank	ğŸ¦
:bar_chart	ğŸ“Š
:barber	ğŸ’ˆ
:baseball	âš¾
:basket:	ğŸ§º
:basketball:	ğŸ€
:basketball_player	â›¹
:bat:	ğŸ¦‡
:bath:	ğŸ›€
:bathtub	ğŸ›
:battery	ğŸ”‹
:bear:	ğŸ»
:bearded_person	ğŸ§”
:beaver	ğŸ¦«
:bee:	ğŸ
:beer:	ğŸº
:beers	ğŸ»
:beetle	ğŸª²
:beginner	ğŸ”°
:bell:	ğŸ””
:bell_pepper	ğŸ«‘
:bento	ğŸ±
:beverage_box	ğŸ§ƒ
:bicyclist	ğŸš´
:bike	ğŸš²
:bikini	ğŸ‘™
:billed_cap	ğŸ§¢
:bird	ğŸ¦
:birthday	ğŸ‚
:bison	ğŸ¦¬
:black_circle	âš«
:black_heart	ğŸ–¤
:black_joker	ğŸƒ
:black_large_square	â¬›
:black_medium_small_square	â—¾
:black_square_button	ğŸ”²
:blond_haired_person	ğŸ‘±
:blossom	ğŸŒ¼
:blowfish	ğŸ¡
:blue_book	ğŸ“˜
:blue_car	ğŸš™
:blue_circle	ğŸ”µ
:blue_heart	ğŸ’™
:blue_square	ğŸŸ¦
:blueberries	ğŸ«
:blush	ğŸ˜Š
:boar	ğŸ—
:bomb	ğŸ’£
:bone	ğŸ¦´
:book:	ğŸ“–
:bookmark:	ğŸ”–
:bookmark_tabs	ğŸ“‘
:books	ğŸ“š
:boom:	ğŸ’¥
:boomerang	ğŸªƒ
:boot	ğŸ‘¢
:bottle_with_popping_cork	ğŸ¾
:bouquet	ğŸ’
:bow:	ğŸ™‡
:bow_and_arrow	ğŸ¹
:bowl_with_spoon	ğŸ¥£
:bowling	ğŸ³
:boxing_glove:	ğŸ¥Š
:boxing_gloves	ğŸ¥Š
:boy	ğŸ‘¦
:brain	ğŸ§ 
:bread	ğŸ
:breast_feeding	ğŸ¤±
:bricks	ğŸ§±
:bridge_at_night	ğŸŒ‰
:briefcase	ğŸ’¼
:briefs	ğŸ©²
:broccoli	ğŸ¥¦
:broken_heart	ğŸ’”
:broom	ğŸ§¹
:brown_circle	ğŸŸ¤
:brown_heart	ğŸ¤
:brown_square	ğŸŸ«
:bubble_tea	ğŸ§‹
:bucket	ğŸª£
:bug	ğŸ›
:bulb	ğŸ’¡
:bullettrain_front	ğŸš…
:bullettrain_side	ğŸš„
:burrito	ğŸŒ¯
:bus:	ğŸšŒ
:busstop	ğŸš
:bust_in_silhouette	ğŸ‘¤
:busts_in_silhouette	ğŸ‘¥
:butter:	ğŸ§ˆ
:butterfly	ğŸ¦‹
:cactus	ğŸŒµ
:cake	ğŸ°
:calendar	ğŸ“†
:call_me:	ğŸ¤™
:call_me_hand	ğŸ¤™
:calling	ğŸ“²
:camel	ğŸ«
:camera:	ğŸ“·
:camera_with_flash	ğŸ“¸
:cancer	â™‹
:candy	ğŸ¬
:canned_food	ğŸ¥«
:canoe	ğŸ›¶
:capital_abcd	ğŸ” 
:capricorn	â™‘
:card_index	ğŸ“‡
:carousel_horse	ğŸ 
:carpentry_saw	ğŸªš
:carrot	ğŸ¥•
:cartwheel	ğŸ¤¸
:cat:	ğŸ±
:cat2	ğŸˆ
:cd	ğŸ’¿
:chair	ğŸª‘
:champagne:	ğŸ¾
:champagne_glass	ğŸ¥‚
:chart:	ğŸ’¹
:chart_with_downwards_trend	ğŸ“‰
:chart_with_upwards_trend	ğŸ“ˆ
:checkered_flag	ğŸ
:cheese:	ğŸ§€
:cheese_wedge	ğŸ§€
:cherries	ğŸ’
:cherry_blossom	ğŸŒ¸
:chestnut	ğŸŒ°
:chicken	ğŸ”
:child:	ğŸ§’
:children_crossing	ğŸš¸
:chocolate_bar	ğŸ«
:chopsticks	ğŸ¥¢
:christmas_tree	ğŸ„
:church	â›ª
:cinema	ğŸ¦
:circus_tent	ğŸª
:city_dusk	ğŸŒ†
:city_sunrise	ğŸŒ‡
:city_sunset	ğŸŒ‡
:cl:	ğŸ†‘
:clap:	ğŸ‘
:clapper	ğŸ¬
:clinking_glass	ğŸ¥‚
:clipboard	ğŸ“‹
:clock1:	ğŸ•
:clock10:	ğŸ•™
:clock1030	ğŸ•¥
:clock11:	ğŸ•š
:clock1130	ğŸ•¦
:clock12:	ğŸ•›
:clock1230	ğŸ•§
:clock130	ğŸ•œ
:clock2:	ğŸ•‘
:clock230	ğŸ•
:clock3:	ğŸ•’
:clock330	ğŸ•
:clock4:	ğŸ•“
:clock430	ğŸ•Ÿ
:clock5:	ğŸ•”
:clock530	ğŸ• 
:clock6:	ğŸ••
:clock630	ğŸ•¡
:clock7:	ğŸ•–
:clock730	ğŸ•¢
:clock8:	ğŸ•—
:clock830	ğŸ•£
:clock9:	ğŸ•˜
:clock930	ğŸ•¤
:closed_book	ğŸ“•
:closed_lock_with_key	ğŸ”
:closed_umbrella	ğŸŒ‚
:clown:	ğŸ¤¡
:clown_face	ğŸ¤¡
:coat	ğŸ§¥
:cockroach	ğŸª³
:cocktail	ğŸ¸
:coconut	ğŸ¥¥
:coffee	â˜•
:coin	ğŸª™
:cold_face	ğŸ¥¶
:cold_sweat	ğŸ˜°
:compass	ğŸ§­
:computer	ğŸ’»
:confetti_ball	ğŸŠ
:confounded	ğŸ˜–
:confused	ğŸ˜•
:construction:	ğŸš§
:construction_worker	ğŸ‘·
:convenience_store	ğŸª
:cookie	ğŸª
:cooking	ğŸ³
:cool	ğŸ†’
:cop	ğŸ‘®
:corn	ğŸŒ½
:couple:	ğŸ‘«
:couple_with_heart	ğŸ’‘
:couplekiss	ğŸ’
:cow:	ğŸ®
:cow2	ğŸ„
:cowboy	ğŸ¤ 
:crab	ğŸ¦€
:credit_card	ğŸ’³
:crescent_moon	ğŸŒ™
:cricket:	ğŸ¦—
:cricket_bat_ball	ğŸ
:cricket_game	ğŸ
:crocodile	ğŸŠ
:croissant	ğŸ¥
:crossed_flags	ğŸŒ
:crown	ğŸ‘‘
:cry:	ğŸ˜¢
:crying_cat_face	ğŸ˜¿
:crystal_ball	ğŸ”®
:cucumber	ğŸ¥’
:cup_with_straw	ğŸ¥¤
:cupcake	ğŸ§
:cupid	ğŸ’˜
:curling_stone	ğŸ¥Œ
:curly_haired	ğŸ¦±
:curly_loop	â°
:currency_exchange	ğŸ’±
:curry	ğŸ›
:custard	ğŸ®
:customs	ğŸ›ƒ
:cut_of_meat	ğŸ¥©
:cyclone	ğŸŒ€
:dancer:	ğŸ’ƒ
:dancers	ğŸ‘¯
:dango	ğŸ¡
:dart	ğŸ¯
:dash	ğŸ’¨
:date	ğŸ“…
:deaf_person	ğŸ§
:deciduous_tree	ğŸŒ³
:deer	ğŸ¦Œ
:department_store	ğŸ¬
:detective	ğŸ•µ
:diamond_shape_with_a_dot_inside	ğŸ’ 
:disappointed:	ğŸ˜
:disappointed_relieved	ğŸ˜¥
:disguised_face	ğŸ¥¸
:diving_mask	ğŸ¤¿
:diya_lamp	ğŸª”
:dizzy:	ğŸ’«
:dizzy_face	ğŸ˜µ
:dna	ğŸ§¬
:do_not_litter	ğŸš¯
:dodo	ğŸ¦¤
:dog:	ğŸ¶
:dog2	ğŸ•
:dollar	ğŸ’µ
:dolls	ğŸ
:dolphin	ğŸ¬
:door	ğŸšª
:doughnut	ğŸ©
:dragon:	ğŸ‰
:dragon_face	ğŸ²
:dress	ğŸ‘—
:dromedary_camel	ğŸª
:drool:	ğŸ¤¤
:drooling_face	ğŸ¤¤
:drop_of_blood	ğŸ©¸
:droplet	ğŸ’§
:drum:	ğŸ¥
:drum_with_drumsticks	ğŸ¥
:duck	ğŸ¦†
:dumpling	ğŸ¥Ÿ
:dvd	ğŸ“€
:e-mail	ğŸ“§
:eagle	ğŸ¦…
:ear:	ğŸ‘‚
:ear_of_rice	ğŸŒ¾
:ear_with_hearing_aid	ğŸ¦»
:earth_africa	ğŸŒ
:earth_americas	ğŸŒ
:earth_asia	ğŸŒ
:egg:	ğŸ¥š
:eggplant	ğŸ†
:electric_plug	ğŸ”Œ
:elephant	ğŸ˜
:elevator	ğŸ›—
:elf	ğŸ§
:email	ğŸ“§
:end	ğŸ”š
:envelope_with_arrow	ğŸ“©
:euro:	ğŸ’¶
:european_castle	ğŸ°
:european_post_office	ğŸ¤
:evergreen_tree	ğŸŒ²
:exclamation	â—
:expecting_woman	ğŸ¤°
:exploding_head	ğŸ¤¯
:expressionless	ğŸ˜‘
:eyeglasses	ğŸ‘“
:eyes	ğŸ‘€
:face_palm	ğŸ¤¦
:face_vomiting	ğŸ¤®
:face_with_cowboy_hat	ğŸ¤ 
:face_with_hand_over_mouth	ğŸ¤­
:face_with_head_bandage	ğŸ¤•
:face_with_monocle	ğŸ§
:face_with_raised_eyebrow	ğŸ¤¨
:face_with_rolling_eyes	ğŸ™„
:face_with_symbols_over_mouth	ğŸ¤¬
:face_with_thermometer	ğŸ¤’
:facepalm	ğŸ¤¦
:factory	ğŸ­
:fairy	ğŸ§š
:falafel	ğŸ§†
:fallen_leaf	ğŸ‚
:family	ğŸ‘ª
:fast_forward	â©
:fax	ğŸ“ 
:fearful	ğŸ˜¨
:feather	ğŸª¶
:feet	ğŸ¾
:fencer	ğŸ¤º
:fencing	ğŸ¤º
:ferris_wheel	ğŸ¡
:field_hockey	ğŸ‘
:file_folder	ğŸ“
:fingers_crossed	ğŸ¤
:fire:	ğŸ”¥
:fire_engine	ğŸš’
:fire_extinguisher	ğŸ§¯
:firecracker	ğŸ§¨
:fireworks	ğŸ†
:first_place:	ğŸ¥‡
:first_place_medal	ğŸ¥‡
:first_quarter_moon:	ğŸŒ“
:first_quarter_moon_with_face	ğŸŒ›
:fish:	ğŸŸ
:fish_cake	ğŸ¥
:fishing_pole_and_fish	ğŸ£
:fist	âœŠ
:flag_black	ğŸ´
:flags	ğŸ
:flame	ğŸ”¥
:flamingo	ğŸ¦©
:flan	ğŸ®
:flashlight	ğŸ”¦
:flatbread	ğŸ«“
:floppy_disk	ğŸ’¾
:flower_playing_cards	ğŸ´
:flushed	ğŸ˜³
:fly:	ğŸª°
:flying_disc	ğŸ¥
:flying_saucer	ğŸ›¸
:foggy	ğŸŒ
:fondue	ğŸ«•
:foot:	ğŸ¦¶
:football	ğŸˆ
:footprints	ğŸ‘£
:fork_and_knife	ğŸ´
:fortune_cookie	ğŸ¥ 
:fountain	â›²
:four_leaf_clover	ğŸ€
:fox:	ğŸ¦Š
:fox_face	ğŸ¦Š
:free	ğŸ†“
:french_bread	ğŸ¥–
:fried_shrimp	ğŸ¤
:fries	ğŸŸ
:frog	ğŸ¸
:frowning	ğŸ˜¦
:fuelpump	â›½
:full_moon:	ğŸŒ•
:full_moon_with_face	ğŸŒ
:game_die	ğŸ²
:garlic	ğŸ§„
:gem:	ğŸ’
:gemini	â™Š
:genie	ğŸ§
:ghost	ğŸ‘»
:gift:	ğŸ
:gift_heart	ğŸ’
:giraffe	ğŸ¦’
:girl	ğŸ‘§
:glass_of_milk	ğŸ¥›
:globe_with_meridians	ğŸŒ
:gloves	ğŸ§¤
:goal:	ğŸ¥…
:goal_net	ğŸ¥…
:goat	ğŸ
:goggles	ğŸ¥½
:golf:	â›³
:golfer	ğŸŒ
:gorilla	ğŸ¦
:grandma	ğŸ‘µ
:grapes	ğŸ‡
:green_apple	ğŸ
:green_book	ğŸ“—
:green_circle	ğŸŸ¢
:green_heart	ğŸ’š
:green_salad	ğŸ¥—
:green_square	ğŸŸ©
:grey_exclamation	â•
:grey_question	â”
:grimacing	ğŸ˜¬
:grin:	ğŸ˜
:grinning	ğŸ˜€
:guard:	ğŸ’‚
:guardsman	ğŸ’‚
:guide_dog	ğŸ¦®
:guitar	ğŸ¸
:gun	ğŸ”«
:haircut	ğŸ’‡
:hamburger	ğŸ”
:hammer	ğŸ”¨
:hamster	ğŸ¹
:hand_splayed	ğŸ–
:hand_with_index_and_middle_finger_crossed	ğŸ¤
:handbag	ğŸ‘œ
:handball	ğŸ¤¾
:handshake	ğŸ¤
:hankey	ğŸ’©
:hatched_chick	ğŸ¥
:hatching_chick	ğŸ£
:head_bandage	ğŸ¤•
:headphones	ğŸ§
:headstone	ğŸª¦
:hear_no_evil	ğŸ™‰
:heart_decoration	ğŸ’Ÿ
:heart_eyes:	ğŸ˜
:heart_eyes_cat	ğŸ˜»
:heartbeat	ğŸ’“
:heartpulse	ğŸ’—
:heavy_division_sign	â—
:heavy_dollar_sign	ğŸ’²
:heavy_minus_sign	â–
:heavy_plus_sign	â•
:hedgehog	ğŸ¦”
:helicopter	ğŸš
:herb	ğŸŒ¿
:hibiscus	ğŸŒº
:high_brightness	ğŸ”†
:high_heel	ğŸ‘ 
:hiking_boot	ğŸ¥¾
:hindu_temple	ğŸ›•
:hippopotamus	ğŸ¦›
:hockey	ğŸ’
:honey_pot	ğŸ¯
:hook	ğŸª
:horse:	ğŸ´
:horse_racing	ğŸ‡
:hospital	ğŸ¥
:hot_dog	ğŸŒ­
:hot_face	ğŸ¥µ
:hotdog	ğŸŒ­
:hotel	ğŸ¨
:hourglass:	âŒ›
:hourglass_flowing_sand	â³
:house:	ğŸ 
:house_with_garden	ğŸ¡
:hugging:	ğŸ¤—
:hugging_face	ğŸ¤—
:hushed	ğŸ˜¯
:hut	ğŸ›–
:ice_cream	ğŸ¨
:ice_cube	ğŸ§Š
:icecream	ğŸ¦
:id:	ğŸ†”
:ideograph_advantage	ğŸ‰
:imp	ğŸ‘¿
:inbox_tray	ğŸ“¥
:incoming_envelope	ğŸ“¨
:information_desk_person	ğŸ’
:innocent	ğŸ˜‡
:izakaya_lantern	ğŸ®
:jack_o_lantern	ğŸƒ
:japan:	ğŸ—¾
:japanese_castle	ğŸ¯
:japanese_goblin	ğŸ‘º
:japanese_ogre	ğŸ‘¹
:jeans	ğŸ‘–
:jigsaw	ğŸ§©
:joy:	ğŸ˜‚
:joy_cat	ğŸ˜¹
:juggler	ğŸ¤¹
:juggling	ğŸ¤¹
:kaaba	ğŸ•‹
:kangaroo	ğŸ¦˜
:karate_uniform	ğŸ¥‹
:kayak	ğŸ›¶
:key:	ğŸ”‘
:keycap_ten	ğŸ”Ÿ
:kimono	ğŸ‘˜
:kiss:	ğŸ’‹
:kissing:	ğŸ˜—
:kissing_cat	ğŸ˜½
:kissing_closed_eyes	ğŸ˜š
:kissing_heart	ğŸ˜˜
:kissing_smiling_eyes	ğŸ˜™
:kite	ğŸª
:kiwi:	ğŸ¥
:kiwifruit	ğŸ¥
:knife	ğŸ”ª
:knot	ğŸª¢
:koala	ğŸ¨
:koko	ğŸˆ
:lab_coat	ğŸ¥¼
:lacrosse	ğŸ¥
:ladder	ğŸªœ
:lady_beetle	ğŸ
:large_blue_diamond	ğŸ”·
:large_orange_diamond	ğŸ”¶
:last_quarter_moon:	ğŸŒ—
:last_quarter_moon_with_face	ğŸŒœ
:laughing	ğŸ˜†
:leafy_green	ğŸ¥¬
:leaves	ğŸƒ
:ledger	ğŸ“’
:left_facing_fist	ğŸ¤›
:left_fist	ğŸ¤›
:left_luggage	ğŸ›…
:leg	ğŸ¦µ
:lemon	ğŸ‹
:leo:	â™Œ
:leopard	ğŸ†
:liar	ğŸ¤¥
:libra	â™
:lifter	ğŸ‹
:light_rail	ğŸšˆ
:link	ğŸ”—
:lion:	ğŸ¦
:lion_face	ğŸ¦
:lips:	ğŸ‘„
:lipstick	ğŸ’„
:lizard	ğŸ¦
:llama	ğŸ¦™
:lobster	ğŸ¦
:lock:	ğŸ”’
:lock_with_ink_pen	ğŸ”
:lollipop	ğŸ­
:long_drum	ğŸª˜
:loop	â¿
:loud_sound	ğŸ”Š
:loudspeaker	ğŸ“¢
:love_hotel	ğŸ©
:love_letter	ğŸ’Œ
:love_you_gesture	ğŸ¤Ÿ
:low_brightness	ğŸ”…
:luggage	ğŸ§³
:lungs	ğŸ«
:lying_face	ğŸ¤¥
:mag:	ğŸ”
:mag_right	ğŸ”
:mage	ğŸ§™
:magic_wand	ğŸª„
:magnet	ğŸ§²
:mahjong	ğŸ€„
:mailbox:	ğŸ“«
:mailbox_closed	ğŸ“ª
:mailbox_with_mail	ğŸ“¬
:mailbox_with_no_mail	ğŸ“­
:male_dancer	ğŸ•º
:mammoth	ğŸ¦£
:man:	ğŸ‘¨
:man_dancing	ğŸ•º
:man_with_chinese_cap	ğŸ‘²
:man_with_gua_pi_mao	ğŸ‘²
:man_with_turban	ğŸ‘³
:mango	ğŸ¥­
:mans_shoe	ğŸ‘
:manual_wheelchair	ğŸ¦½
:maple_leaf	ğŸ
:martial_arts_uniform	ğŸ¥‹
:mask	ğŸ˜·
:massage	ğŸ’†
:mate	ğŸ§‰
:meat_on_bone	ğŸ–
:mechanical_arm	ğŸ¦¾
:mechanical_leg	ğŸ¦¿
:medal	ğŸ…
:mega	ğŸ“£
:melon	ğŸˆ
:memo	ğŸ“
:menorah	ğŸ•
:mens	ğŸš¹
:merperson	ğŸ§œ
:metal	ğŸ¤˜
:metro	ğŸš‡
:microbe	ğŸ¦ 
:microphone	ğŸ¤
:microscope	ğŸ”¬
:middle_finger	ğŸ–•
:military_helmet	ğŸª–
:milk:	ğŸ¥›
:milky_way	ğŸŒŒ
:minibus	ğŸš
:minidisc	ğŸ’½
:mirror	ğŸª
:mobile_phone:	ğŸ“±
:mobile_phone_off	ğŸ“´
:money_mouth:	ğŸ¤‘
:money_mouth_face	ğŸ¤‘
:money_with_wings	ğŸ’¸
:moneybag	ğŸ’°
:monkey:	ğŸ’
:monkey_face	ğŸµ
:monorail	ğŸš
:moon_cake	ğŸ¥®
:mortar_board	ğŸ“
:mosque	ğŸ•Œ
:mosquito	ğŸ¦Ÿ
:mother_christmas	ğŸ¤¶
:motor_scooter	ğŸ›µ
:motorbike	ğŸ›µ
:motorized_wheelchair	ğŸ¦¼
:mount_fuji	ğŸ—»
:mountain_bicyclist	ğŸšµ
:mountain_cableway	ğŸš 
:mountain_railway	ğŸš
:mouse:	ğŸ­
:mouse2	ğŸ
:mouse_trap	ğŸª¤
:movie_camera	ğŸ¥
:moyai	ğŸ—¿
:mrs_claus	ğŸ¤¶
:muscle	ğŸ’ª
:mushroom	ğŸ„
:musical_keyboard	ğŸ¹
:musical_note	ğŸµ
:musical_score	ğŸ¼
:mute	ğŸ”‡
:nail_care	ğŸ’…
:name_badge	ğŸ“›
:nauseated_face	ğŸ¤¢
:nazar_amulet	ğŸ§¿
:necktie	ğŸ‘”
:negative_squared_cross_mark	â
:nerd:	ğŸ¤“
:nerd_face	ğŸ¤“
:nesting_dolls	ğŸª†
:neutral_face	ğŸ˜
:new:	ğŸ†•
:new_moon:	ğŸŒ‘
:new_moon_with_face	ğŸŒš
:newspaper	ğŸ“°
:ng	ğŸ†–
:night_with_stars	ğŸŒƒ
:ninja	ğŸ¥·
:no_bell	ğŸ”•
:no_bicycles	ğŸš³
:no_entry:	â›”
:no_entry_sign	ğŸš«
:no_good	ğŸ™…
:no_mobile_phones	ğŸ“µ
:no_mouth	ğŸ˜¶
:no_pedestrians	ğŸš·
:no_smoking	ğŸš­
:non-potable_water	ğŸš±
:nose	ğŸ‘ƒ
:notebook:	ğŸ““
:notebook_with_decorative_cover	ğŸ“”
:notes	ğŸ¶
:nut_and_bolt	ğŸ”©
:o:	â­•
:ocean	ğŸŒŠ
:octagonal_sign	ğŸ›‘
:octopus	ğŸ™
:oden	ğŸ¢
:office	ğŸ¢
:ok:	ğŸ†—
:ok_hand	ğŸ‘Œ
:ok_woman	ğŸ™†
:older_adult	ğŸ§“
:older_man	ğŸ‘´
:older_woman	ğŸ‘µ
:olive	ğŸ«’
:on:	ğŸ”›
:oncoming_automobile	ğŸš˜
:oncoming_bus	ğŸš
:oncoming_police_car	ğŸš”
:oncoming_taxi	ğŸš–
:one_piece_swimsuit	ğŸ©±
:onion	ğŸ§…
:open_file_folder	ğŸ“‚
:open_hands	ğŸ‘
:open_mouth	ğŸ˜®
:ophiuchus	â›
:orange_book	ğŸ“™
:orange_circle	ğŸŸ 
:orange_heart	ğŸ§¡
:orange_square	ğŸŸ§
:orangutan	ğŸ¦§
:otter	ğŸ¦¦
:outbox_tray	ğŸ“¤
:owl	ğŸ¦‰
:ox	ğŸ‚
:oyster	ğŸ¦ª
:package	ğŸ“¦
:paella	ğŸ¥˜
:page_facing_up	ğŸ“„
:page_with_curl	ğŸ“ƒ
:pager	ğŸ“Ÿ
:palm_tree	ğŸŒ´
:palms_up_together	ğŸ¤²
:pancakes	ğŸ¥
:panda_face	ğŸ¼
:paperclip	ğŸ“
:parachute	ğŸª‚
:parrot	ğŸ¦œ
:partly_sunny	â›…
:partying_face	ğŸ¥³
:passport_control	ğŸ›‚
:paw_prints	ğŸ¾
:peach	ğŸ‘
:peacock	ğŸ¦š
:peanuts	ğŸ¥œ
:pear	ğŸ
:pencil	ğŸ“
:penguin	ğŸ§
:pensive	ğŸ˜”
:people_hugging	ğŸ«‚
:people_with_bunny_ears_partying	ğŸ‘¯
:people_wrestling	ğŸ¤¼
:performing_arts	ğŸ­
:persevere	ğŸ˜£
:person_biking	ğŸš´
:person_bouncing_ball	â›¹
:person_bowing	ğŸ™‡
:person_climbing	ğŸ§—
:person_doing_cartwheel	ğŸ¤¸
:person_facepalming	ğŸ¤¦
:person_fencing	ğŸ¤º
:person_frowning	ğŸ™
:person_gesturing_no	ğŸ™…
:person_gesturing_ok	ğŸ™†
:person_getting_haircut	ğŸ’‡
:person_getting_massage	ğŸ’†
:person_golfing	ğŸŒ
:person_in_lotus_position	ğŸ§˜
:person_in_steamy_room	ğŸ§–
:person_in_tuxedo	ğŸ¤µ
:person_juggling	ğŸ¤¹
:person_kneeling	ğŸ§
:person_lifting_weights	ğŸ‹
:person_mountain_biking	ğŸšµ
:person_playing_handball	ğŸ¤¾
:person_playing_water_polo	ğŸ¤½
:person_pouting	ğŸ™
:person_raising_hand	ğŸ™‹
:person_rowing_boat	ğŸš£
:person_running	ğŸƒ
:person_shrugging	ğŸ¤·
:person_standing	ğŸ§
:person_surfing	ğŸ„
:person_swimming	ğŸŠ
:person_tipping_hand	ğŸ’
:person_walking	ğŸš¶
:person_wearing_turban	ğŸ‘³
:person_with_ball	â›¹
:person_with_blond_hair	ğŸ‘±
:person_with_pouting_face	ğŸ™
:person_with_veil	ğŸ‘°
:petri_dish	ğŸ§«
:pickup_truck	ğŸ›»
:pie	ğŸ¥§
:pig:	ğŸ·
:pig2	ğŸ–
:pig_nose	ğŸ½
:pill	ğŸ’Š
:pinched_fingers	ğŸ¤Œ
:pinching_hand	ğŸ¤
:pineapple	ğŸ
:ping_pong	ğŸ“
:pisces	â™“
:pizza	ğŸ•
:piÃ±ata	ğŸª…
:placard	ğŸª§
:place_of_worship	ğŸ›
:pleading_face	ğŸ¥º
:plunger	ğŸª 
:point_down	ğŸ‘‡
:point_left	ğŸ‘ˆ
:point_right	ğŸ‘‰
:point_up_2	ğŸ‘†
:police_car	ğŸš“
:police_officer	ğŸ‘®
:poo:	ğŸ’©
:poodle	ğŸ©
:poop	ğŸ’©
:popcorn	ğŸ¿
:post_office	ğŸ£
:postal_horn	ğŸ“¯
:postbox	ğŸ“®
:potable_water	ğŸš°
:potato	ğŸ¥”
:potted_plant	ğŸª´
:pouch	ğŸ‘
:poultry_leg	ğŸ—
:pound	ğŸ’·
:pouting_cat	ğŸ˜¾
:pray:	ğŸ™
:prayer_beads	ğŸ“¿
:pregnant_woman	ğŸ¤°
:pretzel	ğŸ¥¨
:prince:	ğŸ¤´
:princess	ğŸ‘¸
:probing_cane	ğŸ¦¯
:pudding	ğŸ®
:punch	ğŸ‘Š
:purple_circle	ğŸŸ£
:purple_heart	ğŸ’œ
:purple_square	ğŸŸª
:purse	ğŸ‘›
:pushpin	ğŸ“Œ
:put_litter_in_its_place	ğŸš®
:question	â“
:rabbit:	ğŸ°
:rabbit2	ğŸ‡
:raccoon	ğŸ¦
:racehorse	ğŸ
:radio:	ğŸ“»
:radio_button	ğŸ”˜
:rage	ğŸ˜¡
:railway_car	ğŸšƒ
:rainbow	ğŸŒˆ
:raised_back_of_hand	ğŸ¤š
:raised_hand:	âœ‹
:raised_hand_with_fingers_splayed	ğŸ–
:raised_hand_with_part_between_middle_and_ring_fingers	ğŸ––
:raised_hands	ğŸ™Œ
:raising_hand	ğŸ™‹
:ram:	ğŸ
:ramen	ğŸœ
:rat	ğŸ€
:razor	ğŸª’
:receipt	ğŸ§¾
:red_car	ğŸš—
:red_circle	ğŸ”´
:red_envelope	ğŸ§§
:red_haired	ğŸ¦°
:red_square	ğŸŸ¥
:regional_indicator_a	ğŸ‡¦
:regional_indicator_b	ğŸ‡§
:regional_indicator_c	ğŸ‡¨
:regional_indicator_d	ğŸ‡©
:regional_indicator_e	ğŸ‡ª
:regional_indicator_f	ğŸ‡«
:regional_indicator_g	ğŸ‡¬
:regional_indicator_h	ğŸ‡­
:regional_indicator_i	ğŸ‡®
:regional_indicator_j	ğŸ‡¯
:regional_indicator_k	ğŸ‡°
:regional_indicator_l	ğŸ‡±
:regional_indicator_m	ğŸ‡²
:regional_indicator_n	ğŸ‡³
:regional_indicator_o	ğŸ‡´
:regional_indicator_p	ğŸ‡µ
:regional_indicator_q	ğŸ‡¶
:regional_indicator_r	ğŸ‡·
:regional_indicator_s	ğŸ‡¸
:regional_indicator_t	ğŸ‡¹
:regional_indicator_u	ğŸ‡º
:regional_indicator_v	ğŸ‡»
:regional_indicator_w	ğŸ‡¼
:regional_indicator_x	ğŸ‡½
:regional_indicator_y	ğŸ‡¾
:regional_indicator_z	ğŸ‡¿
:relieved	ğŸ˜Œ
:repeat:	ğŸ”
:repeat_one	ğŸ”‚
:restroom	ğŸš»
:reversed_hand_with_middle_finger_extended	ğŸ–•
:revolving_hearts	ğŸ’
:rewind	âª
:rhino:	ğŸ¦
:rhinoceros	ğŸ¦
:ribbon	ğŸ€
:rice:	ğŸš
:rice_ball	ğŸ™
:rice_cracker	ğŸ˜
:rice_scene	ğŸ‘
:right_facing_fist	ğŸ¤œ
:right_fist	ğŸ¤œ
:ring:	ğŸ’
:ringed_planet	ğŸª
:robot:	ğŸ¤–
:robot_face	ğŸ¤–
:rock:	ğŸª¨
:rocket	ğŸš€
:rofl	ğŸ¤£
:roll_of_paper	ğŸ§»
:roller_coaster	ğŸ¢
:roller_skate	ğŸ›¼
:rolling_eyes	ğŸ™„
:rolling_on_the_floor_laughing	ğŸ¤£
:rooster	ğŸ“
:rose	ğŸŒ¹
:rotating_light	ğŸš¨
:round_pushpin	ğŸ“
:rowboat	ğŸš£
:rugby_football	ğŸ‰
:runner	ğŸƒ
:running_shirt_with_sash	ğŸ½
:safety_pin	ğŸ§·
:safety_vest	ğŸ¦º
:sagittarius	â™
:sailboat	â›µ
:sake	ğŸ¶
:salad	ğŸ¥—
:salt	ğŸ§‚
:sandal	ğŸ‘¡
:sandwich	ğŸ¥ª
:santa	ğŸ…
:sari	ğŸ¥»
:satellite	ğŸ“¡
:satisfied	ğŸ˜†
:sauropod	ğŸ¦•
:saxophone	ğŸ·
:scarf	ğŸ§£
:school:	ğŸ«
:school_satchel	ğŸ’
:scooter	ğŸ›´
:scorpion	ğŸ¦‚
:scorpius	â™
:scream:	ğŸ˜±
:scream_cat	ğŸ™€
:screwdriver	ğŸª›
:scroll	ğŸ“œ
:seal	ğŸ¦­
:seat	ğŸ’º
:second_place:	ğŸ¥ˆ
:second_place_medal	ğŸ¥ˆ
:see_no_evil	ğŸ™ˆ
:seedling	ğŸŒ±
:selfie	ğŸ¤³
:sewing_needle	ğŸª¡
:shaking_hands	ğŸ¤
:shallow_pan_of_food	ğŸ¥˜
:shark	ğŸ¦ˆ
:shaved_ice	ğŸ§
:sheep	ğŸ‘
:shell:	ğŸš
:shelled_peanut	ğŸ¥œ
:ship	ğŸš¢
:shirt	ğŸ‘•
:shit	ğŸ’©
:shopping_cart	ğŸ›’
:shopping_trolley	ğŸ›’
:shorts	ğŸ©³
:shower	ğŸš¿
:shrimp	ğŸ¦
:shrug	ğŸ¤·
:shushing_face	ğŸ¤«
:sick	ğŸ¤¢
:sign_of_the_horns	ğŸ¤˜
:signal_strength	ğŸ“¶
:six_pointed_star	ğŸ”¯
:skateboard	ğŸ›¹
:skeleton	ğŸ’€
:ski	ğŸ¿
:skull	ğŸ’€
:skunk	ğŸ¦¨
:sled	ğŸ›·
:sleeping:	ğŸ˜´
:sleeping_accommodation	ğŸ›Œ
:sleepy	ğŸ˜ª
:sleuth_or_spy	ğŸ•µ
:slight_frown	ğŸ™
:slight_smile	ğŸ™‚
:slightly_frowning_face	ğŸ™
:slightly_smiling_face	ğŸ™‚
:slot_machine	ğŸ°
:sloth	ğŸ¦¥
:small_blue_diamond	ğŸ”¹
:small_orange_diamond	ğŸ”¸
:small_red_triangle:	ğŸ”º
:small_red_triangle_down	ğŸ”»
:smile:	ğŸ˜„
:smile_cat	ğŸ˜¸
:smiley:	ğŸ˜ƒ
:smiley_cat	ğŸ˜º
:smiling_face_with_3_hearts	ğŸ¥°
:smiling_face_with_tear	ğŸ¥²
:smiling_imp	ğŸ˜ˆ
:smirk:	ğŸ˜
:smirk_cat	ğŸ˜¼
:smoking	ğŸš¬
:snail	ğŸŒ
:snake	ğŸ
:sneeze	ğŸ¤§
:sneezing_face	ğŸ¤§
:snowboarder	ğŸ‚
:snowman	â›„
:soap	ğŸ§¼
:sob	ğŸ˜­
:soccer	âš½
:socks	ğŸ§¦
:softball	ğŸ¥
:soon	ğŸ”œ
:sos	ğŸ†˜
:sound	ğŸ”‰
:space_invader	ğŸ‘¾
:spaghetti	ğŸ
:sparkler	ğŸ‡
:sparkles	âœ¨
:sparkling_heart	ğŸ’–
:speak_no_evil	ğŸ™Š
:speaker	ğŸ”ˆ
:speech_balloon	ğŸ’¬
:speedboat	ğŸš¤
:sponge	ğŸ§½
:spoon	ğŸ¥„
:sports_medal	ğŸ…
:spy	ğŸ•µ
:squeeze_bottle	ğŸ§´
:squid	ğŸ¦‘
:star:	â­
:star2	ğŸŒŸ
:star_struck	ğŸ¤©
:stars	ğŸŒ 
:station	ğŸš‰
:statue_of_liberty	ğŸ—½
:steam_locomotive	ğŸš‚
:stethoscope	ğŸ©º
:stew	ğŸ²
:stop_sign	ğŸ›‘
:straight_ruler	ğŸ“
:strawberry	ğŸ“
:stuck_out_tongue:	ğŸ˜›
:stuck_out_tongue_closed_eyes	ğŸ˜
:stuck_out_tongue_winking_eye	ğŸ˜œ
:stuffed_flatbread	ğŸ¥™
:stuffed_pita	ğŸ¥™
:sun_with_face	ğŸŒ
:sunflower	ğŸŒ»
:sunglasses	ğŸ˜
:sunrise:	ğŸŒ…
:sunrise_over_mountains	ğŸŒ„
:superhero	ğŸ¦¸
:supervillain	ğŸ¦¹
:surfer	ğŸ„
:sushi	ğŸ£
:suspension_railway	ğŸšŸ
:swan	ğŸ¦¢
:sweat:	ğŸ˜“
:sweat_drops	ğŸ’¦
:sweat_smile	ğŸ˜…
:sweet_potato	ğŸ 
:swimmer	ğŸŠ
:symbols	ğŸ”£
:synagogue	ğŸ•
:syringe	ğŸ’‰
:t_rex	ğŸ¦–
:table_tennis	ğŸ“
:taco	ğŸŒ®
:tada	ğŸ‰
:takeout_box	ğŸ¥¡
:tamale	ğŸ«”
:tanabata_tree	ğŸ‹
:tangerine	ğŸŠ
:taurus	â™‰
:taxi	ğŸš•
:tea:	ğŸµ
:teapot	ğŸ«–
:teddy_bear	ğŸ§¸
:telephone_receiver	ğŸ“
:telescope	ğŸ”­
:tennis	ğŸ¾
:tent	â›º
:test_tube	ğŸ§ª
:thermometer_face	ğŸ¤’
:thinking:	ğŸ¤”
:thinking_face	ğŸ¤”
:third_place:	ğŸ¥‰
:third_place_medal	ğŸ¥‰
:thong_sandal	ğŸ©´
:thought_balloon	ğŸ’­
:thread	ğŸ§µ
:thumbdown	ğŸ‘
:thumbsdown	ğŸ‘
:thumbsup	ğŸ‘
:thumbup	ğŸ‘
:ticket	ğŸ«
:tiger:	ğŸ¯
:tiger2	ğŸ…
:tired_face	ğŸ˜«
:toilet	ğŸš½
:tokyo_tower	ğŸ—¼
:tomato	ğŸ…
:tone1	ğŸ»
:tone2	ğŸ¼
:tone3	ğŸ½
:tone4	ğŸ¾
:tone5	ğŸ¿
:tongue	ğŸ‘…
:toolbox	ğŸ§°
:tooth:	ğŸ¦·
:toothbrush	ğŸª¥
:top:	ğŸ”
:tophat	ğŸ©
:tractor	ğŸšœ
:traffic_light	ğŸš¥
:train:	ğŸš‹
:train2	ğŸš†
:tram	ğŸšŠ
:transgender_symbol	âš§
:triangular_flag_on_post	ğŸš©
:triangular_ruler	ğŸ“
:trident	ğŸ”±
:triumph	ğŸ˜¤
:trolleybus	ğŸš
:trophy	ğŸ†
:tropical_drink	ğŸ¹
:tropical_fish	ğŸ 
:truck	ğŸšš
:trumpet	ğŸº
:tulip	ğŸŒ·
:tumbler_glass	ğŸ¥ƒ
:turkey	ğŸ¦ƒ
:turtle	ğŸ¢
:tv	ğŸ“º
:twisted_rightwards_arrows	ğŸ”€
:two_hearts	ğŸ’•
:two_men_holding_hands	ğŸ‘¬
:two_women_holding_hands	ğŸ‘­
:u5272	ğŸˆ¹
:u5408	ğŸˆ´
:u55b6	ğŸˆº
:u6307	ğŸˆ¯
:u6709	ğŸˆ¶
:u6e80	ğŸˆµ
:u7121	ğŸˆš
:u7533	ğŸˆ¸
:u7981	ğŸˆ²
:u7a7a	ğŸˆ³
:umbrella	â˜”
:unamused	ğŸ˜’
:underage	ğŸ”
:unicorn:	ğŸ¦„
:unicorn_face	ğŸ¦„
:unlock	ğŸ”“
:up:	ğŸ†™
:upside_down:	ğŸ™ƒ
:upside_down_face	ğŸ™ƒ
:vampire	ğŸ§›
:vertical_traffic_light	ğŸš¦
:vhs	ğŸ“¼
:vibration_mode	ğŸ“³
:video_camera	ğŸ“¹
:video_game	ğŸ®
:violin	ğŸ»
:virgo	â™
:volcano	ğŸŒ‹
:volleyball	ğŸ
:vs	ğŸ†š
:vulcan	ğŸ––
:waffle	ğŸ§‡
:walking	ğŸš¶
:waning_crescent_moon	ğŸŒ˜
:waning_gibbous_moon	ğŸŒ–
:watch	âŒš
:water_buffalo	ğŸƒ
:water_polo	ğŸ¤½
:watermelon	ğŸ‰
:wave	ğŸ‘‹
:waving_black_flag	ğŸ´
:waxing_crescent_moon	ğŸŒ’
:waxing_gibbous_moon	ğŸŒ”
:wc	ğŸš¾
:weary	ğŸ˜©
:wedding	ğŸ’’
:weight_lifter	ğŸ‹
:whale:	ğŸ³
:whale2	ğŸ‹
:wheelchair	â™¿
:whisky	ğŸ¥ƒ
:white_check_mark	âœ…
:white_circle	âšª
:white_flower	ğŸ’®
:white_haired	ğŸ¦³
:white_heart	ğŸ¤
:white_large_square	â¬œ
:white_medium_small_square	â—½
:white_square_button	ğŸ”³
:wilted_flower	ğŸ¥€
:wilted_rose	ğŸ¥€
:wind_chime	ğŸ
:window	ğŸªŸ
:wine_glass	ğŸ·
:wink	ğŸ˜‰
:wolf	ğŸº
:woman:	ğŸ‘©
:woman_with_headscarf	ğŸ§•
:womans_clothes	ğŸ‘š
:womans_flat_shoe	ğŸ¥¿
:womans_hat	ğŸ‘’
:womens	ğŸšº
:wood	ğŸªµ
:woozy_face	ğŸ¥´
:worm	ğŸª±
:worried	ğŸ˜Ÿ
:worship_symbol	ğŸ›
:wrench	ğŸ”§
:wrestlers	ğŸ¤¼
:wrestling	ğŸ¤¼
:x	âŒ
:yarn	ğŸ§¶
:yawning_face	ğŸ¥±
:yellow_circle	ğŸŸ¡
:yellow_heart	ğŸ’›
:yellow_square	ğŸŸ¨
:yen	ğŸ’´
:yo_yo	ğŸª€
:yum	ğŸ˜‹
:zany_face	ğŸ¤ª
:zap	âš¡
:zebra	ğŸ¦“
:zipper_mouth:	ğŸ¤
:zipper_mouth_face	ğŸ¤
:zombie	ğŸ§Ÿ
:zzz	ğŸ’¤
